,GeneName,Start,End,Length,RegionType,ProteinRegionSeq
0,sp|Q9H2S9|IKZF4_HUMAN,98,150,52,Prediction,IKVEMYSDEESSRLLGPDERLLEKDDSVIVEDSLSEPLGYCDGSGPEPHSPG
1,sp|P28698|MZF1_HUMAN,173,226,53,Prediction,MQESPLGLQVKEESEVTEDSDFLESGPLAATQESVPTLLPEEAQRCGTVLDQI
2,sp|Q8N9K5|ZN565_HUMAN,128,175,47,Prediction,KDIFEIGAFNWEIMESLKCSDLEGSDFRADWECEGQFERQVNEECYF
3,sp|Q01892|SPIB_HUMAN,107,153,46,Prediction,ENFASQTLVPPAYAPYPSPVLSEEEDLPLDSPALEVSDSESDEALV
4,sp|O60281|ZN292_HUMAN,2481,2520,39,Prediction,DELTELFITKLINEDSTSVETQANTSSNVSNDFQEDNLC
5,sp|Q9NQX6|ZN331_HUMAN,10,52,42,Prediction,VAIDFSQEEWACLNSAQRDLYWDVMLENYSNLVSLDLESAYE
6,sp|Q8N1W2|ZN710_HUMAN,26,65,39,Prediction,LVSENELFGATISAEAFYPDLGPELSGAAMGEPEPPGPD
7,sp|Q8N1W2|ZN710_HUMAN,196,256,60,Prediction,DGFPEPSMALPGPEALPTECGFEPPHLAPLSDPEAPSMESPEPVKPEQGFVWQEASEFEA
8,sp|A6NFI3|ZN316_HUMAN,141,246,105,Prediction,EDEDEDDLLTAGCQELVTFEDVAVYFSLEEWERLEADQRGLYQEVMQENYGILVSLGYPIPKPDLIFRLEQGEEPWVPDSPRPEEGDIVTGVYTGAWFWTDDIED
9,sp|P50553|ASCL1_HUMAN,197,236,39,Prediction,SNDLNSMAGSPVSSYSSDEGSYDPLSPEEQELLDFTNWF
10,sp|Q14872|MTF1_HUMAN,42,96,54,Prediction,VYDRTTVLIEQDPGTLEDEDDDGQCGEHLPFLVGGEEGFHLIDHEAMSQGYVQH
11,sp|Q14872|MTF1_HUMAN,704,748,44,Prediction,SDPQTETLSAMDVSEFLSLQSLDTPSNLIPIEALLQGEEEMGLT
12,sp|Q33E94|RFX4_HUMAN,364,406,42,Prediction,TMEDSRDEHRKLITQLYQEFDHLLEEQSPIESYIEWLDTMVD
13,sp|Q9Y330|ZBT12_HUMAN,163,215,52,Prediction,PKPPPPPPLPPPLLRPVKLEFPLDEDLELKAEEEDEDEDEDVSDICIVKVES
14,sp|O95125|ZN202_HUMAN,0,49,49,Prediction,MATAVEPEDQDLWEEEGILMVKLEDDFTCRPESVLQRDDPVLETSHQNF
15,sp|O95125|ZN202_HUMAN,193,368,175,Prediction,QEEELQTLQESEVPVPEDPDLPAERSSGDSEMVALLTALSQGLVTFKDVAVCFSQDQWSDLDPTQKEFYGEYVLEEDCGIVVSLSFPIPRPDEISQVREEEPWVPDIQEPQETQEPEILSFTYTGDRSKDEEECLEQEDLSLEDIHRPVLGEPEIHQTPDWEIVFEDNPGRLNER
16,sp|Q99941|ATF6B_HUMAN,6,91,85,Prediction,LSEIADPTRFFTDNLLSPEDWGLQNSTLYSGLDEVAEEQTQLFRCPEQDVPFDGSSLDVGMDVSPSEPPWELLPIFPDLQVKSEP
17,sp|Q92766|RREB1_HUMAN,1336,1390,54,Prediction,EEHGTEESTGDADGAEEDASSNQSLDLDFATKLMDFKLAEGDGEAGAGGAASQE
18,sp|Q9ULD5|ZN777_HUMAN,397,441,44,Prediction,FQDSELGDPCGEQPDLDMQEPENTLEESTEGSSEFSELKQMLVQ
19,sp|O75030|MITF_HUMAN,223,263,40,Prediction,DDVIDDIISLESSYNEEILGLMDPALQMANTLPVSGNLID
20,sp|Q6PG37|ZN790_HUMAN,9,47,38,Prediction,VAVDFSQEEWECLDLEQRDLYRDVMLENYSNMVSLGFC
21,sp|O43422|P52K_HUMAN,131,180,49,Prediction,TNNSNAQNPSEEEGEGQDEDILPLTLEEKENKEYLKSLFEILILMGKQN
22,sp|O43422|P52K_HUMAN,247,307,60,Prediction,EETLREVRDSHFFSIITDDVVDIAGEEHLPVLVRFVDESHNLREEFIGFLPYEADAEILA
23,sp|Q9C0G0|ZN407_HUMAN,1129,1168,39,Prediction,LNENTNLDMSKVLCAADSVEVETEEESNFNEDHSFCETF
24,sp|Q9C0G0|ZN407_HUMAN,1287,1329,42,Prediction,GHGLEDLKGVQEDPVLGNKEILMNSQHETEFILEEDGPASDS
25,sp|Q16665|HIF1A_HUMAN,71,115,44,Prediction,LLDAGDLDIEDDMKAQMNCFYLKALDGFVMVLTDDGDMIYISDN
26,sp|Q16665|HIF1A_HUMAN,389,450,61,Prediction,LKKEPDALTLLAPAAGDTIISLDFGSNDTETDDQQLEEVPLYNDVMLPSPNEKLQNINLAM
27,sp|Q16665|HIF1A_HUMAN,507,594,87,Prediction,QSSPEPNSPSEYCFYVDSDMVNEFKLELVEKLFAEDTEAKNPFSTQDTDLDLEMLAPYIPMDDDFQLRSFDQLSPLESSSASPESAS
28,sp|Q9P2J8|ZN624_HUMAN,29,75,46,Prediction,SPEVTQPDEDLHLQAEETQLVKESVTFKDVAIDFTLEEWRLMDPTQ
29,sp|Q9UC06|ZNF70_HUMAN,20,73,53,Prediction,SQQGLFPGEDLGDPFLQERGLEQMAVIYKEIPLGEQDEENDDYEGNFSLCSSP
30,sp|Q8NHM5|KDM2B_HUMAN,50,89,39,Prediction,DENEDLSDVEEIVSVRGFSLEEKLRSQLYQGDFVHAMEG
31,sp|Q5SXM2|SNPC4_HUMAN,69,108,39,Prediction,DEDDPKDKTLPEDPETCLQLNMVYQEVIQEKLAEANLLL
32,sp|Q9HBT7|ZN287_HUMAN,118,156,38,Prediction,DLTQILEEEAPQNSTLSQDTPEEDPRGKHAFQTGWLND
33,sp|Q8NI51|CTCFL_HUMAN,41,101,60,Prediction,RSPSELEAERTSGAFQDSVLEEEVELVLAPSEESEKYILTLQTVHFTSEAVELQDMSLLS
34,sp|Q8NI51|CTCFL_HUMAN,146,229,83,Prediction,EMEVLQFHALEENVMVASEDSKLAVSLAETTGLIKLEEEQEKNQLLAERTKEQLFFVETMSGDERSDEIVLTVSNSNVEEQED
35,sp|O14948|TFEC_HUMAN,29,85,56,Prediction,HTTLDSDAGLTENPLTKLLAIGKEDDNAQWHMEDVIEDIIGMESSFKEEGADSPLL
36,sp|Q01094|E2F1_HUMAN,369,437,68,Prediction,DEDRLSPLVAADSLLEHVREDFSGLLPEEFISLSPPHEALDYHFGLEEGEGIRDLFDCDFGDLTPLDF
37,sp|Q86WP2|GPBP1_HUMAN,371,427,56,Prediction,FPQTDVLSSSLEAEHRLLKEMGWQEDSENDETCAPLTEDEMREFQVISEQLQKNGL
38,sp|O43313|ATMIN_HUMAN,630,690,60,Prediction,NPGIDFDIEEFFSASNIQTQTEESELSTMTTEPVLESLDIETQTDFLLADTSAQSYGCRG
39,sp|P62508|ERR3_HUMAN,296,345,49,Prediction,QMSLLQSAWMEILILGVVYRSLSFEDELVYADDYIMDEDQSKLAGLLDL
40,sp|Q9UJV8|PURG_HUMAN,212,277,65,Prediction,GHSLGQEQTIVLPAQGMIEFRDALVQLIEDYGEGDIEERRGGDDDPLELPEGTSFRVDNKRFYFD
41,sp|Q16254|E2F4_HUMAN,340,408,68,Prediction,DPTGVLELPKELSEIFDPTRECMSSELLEELMSSEVFAPLLRLSPPPGDHDYIYNLDESEGVCDLFDV
42,sp|P37231|PPARG_HUMAN,5,43,38,Prediction,GDSPIDPESDSFTDTLSANISQEMTMVDTEMPFWPTNF
43,sp|Q9Y2P0|ZN835_HUMAN,1,42,41,Prediction,EGLLSVALQGAELEGNWKHEGQVEDLQENQESCPEPEAVAC
44,sp|P13631|RARG_HUMAN,308,361,53,Prediction,DLVFAFAGQLLPLEMDDTETGLLSAICLICGDRMDLEEPEKVDKLQEPLLEAL
45,sp|Q00613|HSF1_HUMAN,470,521,51,Prediction,QPLFLLDPGSVDTGSNDLPVLFELGEGSYFSEGDGFAEDPTISLLTGSEPP
46,sp|O95600|KLF8_HUMAN,50,91,41,Prediction,LLDANPMENPALFNDIKIEPPEELLASDFSLPQVEPVDLSF
47,sp|Q92754|AP2C_HUMAN,146,193,47,Prediction,DLLLPHAHALDAAGLAENLGLHDMPHQMDEVQNVDDQHLLLHDQTVI
48,sp|Q9P215|POGK_HUMAN,23,124,101,Prediction,RELEDGPADMQKVRICSEGGWVPALFDEVAIYFSDEEWEVLTEQQKALYREVMRMNYETVLSLEFPFPKPDMITRLEGEEESQNSDEWQLQGGTSAENEES
49,sp|P10243|MYBA_HUMAN,341,388,47,Prediction,AVEANAVLSSLQTIPEFAETLELIESDPVAWSDVTSFDISDAAASPI
50,sp|Q9BYV9|BACH2_HUMAN,128,166,38,Prediction,LQTQLLNSEDGLFVCRKDAACQRPHEDCENSAGEEEDE
51,sp|Q6NX49|ZN544_HUMAN,41,79,38,Prediction,VTLETWEHIVSLGLFLSKSDVISQLEQEEDLCRAEQEA
52,sp|Q92782|DPF1_HUMAN,145,192,47,Prediction,ALLCAETGEKKIELKEEETIMDCQKQQLLEFPHDLEVEDLEDDIPRR
53,sp|Q9P0J7|KCMF1_HUMAN,302,362,60,Prediction,ETERQSMESERADRSLFVQELLLSTLVREESSSSDEDDRGEMADFGAMGCVDIMPLDVAL
54,sp|Q9C0K0|BC11B_HUMAN,8,71,63,Prediction,PQHLSQRELITPEADHVEAAILEEDEGLEIEEPSGLGLMVGGPDPDLLTCGQCQMNFPLGDIL
55,sp|Q5VV52|ZN691_HUMAN,8,52,44,Prediction,SAEMSLFLQGPEEMLPLSSEGSEMGSEKEQSPEPHLPEEGEGGK
56,sp|P52746|ZN142_HUMAN,673,776,103,Prediction,PHGGDLGGSPSPAEVEEGSCTLHLEALGVELESVTEPPLEEVTETAPMEFRPLGLEGPDGLEGPELSSFEGIGTSDLSAEENPLLEKPVSEPSTNPPSLEEAP
57,sp|P52746|ZN142_HUMAN,917,958,41,Prediction,SEDTESGKPPPASQEAELLLPKDAPLELPREPEETEEPLAT
58,sp|O15370|SOX12_HUMAN,148,303,155,Prediction,RAAGGPLGGGAAAPEDDDEDDDEELLEVRLVETPGRELWRMVPAGRAARGQAERAQGPSGEGAAAAAAASPTPSEDEEPEEEEEEAAAAEEGEEETVASGEESLGFLSRLPPGPAGLDCSALDRDPDLQPPSGTSHFEFPDYCTPEVTEMIAGDW
59,sp|Q8TEY5|CR3L4_HUMAN,1,40,39,Prediction,DLGIPDLLDAWLEPPEDIFSTGSVLELGLHCPPPEVPVT
60,sp|P15918|RAG1_HUMAN,562,604,42,Prediction,DSALVSALMDMEEDILEGMRSQDLDDYLNGPFTVVVKESCDG
61,sp|Q9H175|CSRN2_HUMAN,136,186,50,Prediction,KLTKNGTVESVEADGLTLDDVSDEDIDVENVEVDDYFFLQPLPTKRRRAL
62,sp|Q9H175|CSRN2_HUMAN,301,378,77,Prediction,LTGAQGSETQDFQEFIAENETAVMHLQSAEELERLKAEEDSSGSSASLDSSIESLGVCILEEPLAVPEELCPGLTAP
63,sp|Q9H175|CSRN2_HUMAN,464,522,58,Prediction,TDPAALCKSEVGKTPTLEALLPEDCNPEEPENEDFHPSWSPSSLPFRTDNEEGCGMVK
64,sp|Q9BWM5|ZN416_HUMAN,39,78,39,Prediction,EEWGLLDEAQRLLYRDVMLENFALITALVCWHGMEDEET
65,sp|Q9Y4A8|NF2L3_HUMAN,366,435,69,Prediction,PVDNHMRNLTSQDLLYDLDINIFDEINLMSLATEDNFDPIDVSQLFDEPDSDSGLSLDSSHNNTSVIKS
66,sp|Q96SZ4|ZSC10_HUMAN,160,199,39,Prediction,QALQESSPQGPSPWPEESSRDQELAAVLECLTFEDVPEN
67,sp|Q86XU0|ZN677_HUMAN,12,59,47,Prediction,VAIEFSQEEWECLDPAQRALYRDVMLENYRNLLSLDEDNIPPEDDIS
68,sp|Q96S65|CSRN1_HUMAN,145,184,39,Prediction,EEKLEMLQWKLSAAGVPQAEAGLPPVVDAIDDASVEEDL
69,sp|Q96S65|CSRN1_HUMAN,368,445,77,Prediction,PDCPTHPGLPGPGFQPGVDDDSLARILSFSDSDFGGEEEEEEEGSVGNLDNLSCFHPADIFGTSDPGGLASWTHSYS
70,sp|Q96S65|CSRN1_HUMAN,538,589,51,Prediction,LPGLSPPGDASSCFLESLMGFSEPAAEALDPFIDSQFEDTVPASLMEPVPV
71,sp|P18850|ATF6A_HUMAN,5,92,87,Prediction,GVAGTMESPFSPGLFHRLDEDWDSALFAELGYFTDTDELQLEAANETYENNFDNLDFDLDLMPWESDIWDINNQICTVKDIKAEPQP
72,sp|Q9Y5A6|ZSC21_HUMAN,77,139,62,Prediction,IHTKEQILELLVLEQFLTILPQELQAWVQEHCPESAEEAVTLLEDLERELDEPGHQVSTPPN
73,sp|Q99676|ZN184_HUMAN,112,153,41,Prediction,EPDISEEELSPEVIVEKHKRDDSWSSNLLESWEYEGSLERQ
74,sp|Q8N123|CPXCR_HUMAN,54,98,44,Prediction,TATSQEDVVPQAAENSELETEIQKDQREEDLKEELLLLQTPIPR
75,sp|Q8IWY8|ZSC29_HUMAN,54,102,48,Prediction,EQIVELLVLEQFLTVLPGEIQNWVQEQCPENGEEAVTLVEDLEREPGR
76,sp|Q8IWY8|ZSC29_HUMAN,322,361,39,Prediction,FFEEMEALMSAQVIALPSNGLEAAASHSGLVGSDAETEE
77,sp|Q9P0L1|ZKSC7_HUMAN,300,340,40,Prediction,LFGVVPGAAETGDVCEDTFKELEGQTSDEEGSRLENDFLE
78,sp|O14545|TRAD1_HUMAN,231,308,77,Prediction,EGGEESANLDFMLALSLQNEGQASSVAEQDFWRAVCEADQSHGGPRSLSDIKGAADEIMLPCEFCEELYPEELLIDH
79,sp|O14545|TRAD1_HUMAN,348,391,43,Prediction,QLDSLMGLSNSHPVEESIIIPCEFCGVQLEEEVLFHHQDQCDQ
80,sp|Q8IVP9|ZN547_HUMAN,22,61,39,Prediction,EEWGHLDEAQRLLYRDVMLENLALLSSLGCCHGAEDEEA
81,sp|Q9BQA5|HINFP_HUMAN,15,162,147,Prediction,QCEWGSCSFVCSTMEKFFEHVTQHLQQHLHGSGEEEEEEEEDDPLEEEFSCLWQECGFCSLDSSADLIRHVYFHCYHTKLKQWGLQALQSQADLGPCILDFQSRNVIPDIPDHFLCLWEHCENSFDNPEWFYRHVEAHSLCCEYEAV
82,sp|Q96JM2|ZN462_HUMAN,387,427,40,Prediction,SDEELNEIDSENGLSAMDHQTSGLSAEQLMGSDGNKLLET
83,sp|Q9NQV6|PRD10_HUMAN,100,192,92,Prediction,LPVHNQVLPSIESVDGSDPLATLQTPLGRLEAKEEEDEDEDEDTEEDEEEDGEDTDLDDWEPDPPRPFDPHDLWCEECNNAHASVCPKHGPL
84,sp|Q9NQV6|PRD10_HUMAN,413,463,50,Prediction,LEITSENGEKSDDGTQDLLHFPTKEQFDEAEPATLNGLDQPEQTTIPIPQ
85,sp|Q8N187|CARTF_HUMAN,631,673,42,Prediction,MGNLPEPDQNLVAMDELVEVGDVEDTGNLEGTVHRILLGDVQ
86,sp|Q9NRM2|ZN277_HUMAN,252,330,78,Prediction,PKNREYDRFYVINYLELGKSWEEVQLEDDRELLDHQEDDWSDWEEHPASAVCLFCEKQAETIEKLYVHMEDAHEFDLL
87,sp|Q9NRM2|ZN277_HUMAN,385,439,54,Prediction,PDRKTWDQLEYYFPTYENDTLLCTLSDSESDLTAQEQNENVPIISEDTSKLYAL
88,sp|Q12830|BPTF_HUMAN,398,437,39,Prediction,LGDLLCCETCSAVYHLECVKPPLEEVPEDEWQCEVCVAH
89,sp|Q12830|BPTF_HUMAN,476,540,64,Prediction,LIIEEDTENENEKKIWYYSTKVQLAELIDCLDKDYWEAELCKILEEMREEIHRHMDITEDLTNK
90,sp|Q49AG3|ZBED5_HUMAN,301,340,39,Prediction,EEDLLLCESLQSNATGEEIFNCINSFMQKHEIEWEKCVD
91,sp|Q49AG3|ZBED5_HUMAN,511,551,40,Prediction,LEFWASSVEEENFDCFPTLSDFLTEINSTVDKDICSAIVQ
92,sp|O75461|E2F6_HUMAN,136,192,56,Prediction,VPQQKKLQEELSDLSAMEDALDELIKDCAQQLFELTDDKENERLAYVTYQDIHSIQ
93,sp|Q9NU39|FX4L1_HUMAN,26,75,49,Prediction,IDVLGEEEDEDEVEDEEEEASQKFLEQSLQPGLQVARWGGVALPREHIE
94,sp|P49715|CEBPA_HUMAN,44,85,41,Prediction,PPAAPEPLGGICEHETSIDISAYIDPAAFNDEFLADLFQHS
95,sp|P17028|ZNF24_HUMAN,92,192,100,Prediction,ELVVLEQFVAILPKELQTWVRDHHPENGEEAVTVLEDLESELDDPGQPVSLRRRKREVLVEDMVSQEEAQGLPSSELDAVENQLKWASWELHSLRHCDDD
96,sp|Q8TF50|ZN526_HUMAN,58,123,65,Prediction,CSECGSLYNTLEEVLSHQEQHMLAVSEEEALTTQNVGLEPELVPGAEGPFQCGECSQLILSPGEL
97,sp|Q8TF50|ZN526_HUMAN,193,238,45,Prediction,MEPYECPECSTLCATPEEFLEHQGTHFDSLEKEERNGLEEEEEDD
98,sp|Q53GI3|ZN394_HUMAN,96,139,43,Prediction,LLSKEQILELLVLEQFLTILPEELQAWVREHCPESGEEAVAVV
99,sp|Q8NB42|ZN527_HUMAN,71,130,59,Prediction,PWMVERKMSQGHCADWESWCEIEELSPKWFIDEDEISQEMVMERLASHGLECSSFREAW
100,sp|P11473|VDR_HUMAN,186,239,53,Prediction,SDHCITSSDMMDSSSFSNLDLSEEDSDDPSVTLELSQLSMLPHLADLVSYSIQ
101,sp|Q9NS37|ZHANG_HUMAN,72,155,83,Prediction,VAVRAPSPEEMEEEAIASLPGEETEDMDFLSGLELADLLDPRQPDWHLDPGLSSPGPLSSSGGGSDSGGLWRGDDDDEAAAAE
102,sp|Q9Y6Q9|NCOA3_HUMAN,786,826,40,Prediction,TETSEEGSGDLDNLDAILGDLTSSDFYNNSISSNGSHLGT
103,sp|Q9Y6Q9|NCOA3_HUMAN,1032,1073,41,Prediction,SLDDLVGPPSNLEGQSDERALLDQLHTLLSNTDATGLEEID
104,sp|Q86TJ5|ZN554_HUMAN,25,78,53,Prediction,FSQEERMAAGYLPRWSQELVTFEDVSMDFSQEEWELLEPAQKNLYREVMLENY
105,sp|Q2KHR2|RFX7_HUMAN,749,814,65,Prediction,IQAHSSDQLPLQSELKEFEPSVSQTNESYFPFDDELTQDSIVEELVLMEQQMSMNNSHSYGNCLG
106,sp|Q2KHR2|RFX7_HUMAN,1290,1356,66,Prediction,SELSGSINDLNTLDPNLLFDPGRQQGQDDEATLEELKNDPLFQQICSESMNSMTSSGFEWIESKDH
107,sp|P98182|ZN200_HUMAN,100,158,58,Prediction,QETVSLYLKANPEELVVFEDLNVFHCQEECVSLDPTQQLTSEKEDDSSVGEMMLLAVN
108,sp|O15353|FOXN1_HUMAN,130,194,64,Prediction,HEDVFPEAETTLALKGHSFKTPGPLEAFEEIPVDVAEAEAFLPGFSAEAWCNGLPYPSQEHGPQ
109,sp|O15353|FOXN1_HUMAN,513,562,49,Prediction,TMHDTLLPDGDLGTDLDAINPSLTDFDFQGNLWEQLKDDSLALDPLVLV
110,sp|P10826|RARB_HUMAN,306,358,52,Prediction,DLVFTFANQLLPLEMDDTETGLLSAICLICGDRQDLEEPTKVDKLQEPLLEA
111,sp|Q8NEP9|ZN555_HUMAN,1,49,48,Prediction,DSVVFEDVAVDFTLEEWALLDSAQRDLYRDVMLETFQNLASVDDETQF
112,sp|Q8IUX7|AEBP1_HUMAN,9,67,58,Prediction,LSCLLALLALCPGGRPQTVLTDDEIEEFLEGFLSELEPEPREDDVEAPPPPEPTPRVR
113,sp|Q8IUX7|AEBP1_HUMAN,662,715,53,Prediction,HLVPSLNPDGYEVAAQMGSEFGNWALGLWTEEGFDIFEDFPDLNSVLWGAEER
114,sp|Q8IUX7|AEBP1_HUMAN,1082,1158,76,Prediction,TETYTEVVTEFGTEVEPEFGTKVEPEFETQLEPEFETQLEPEFEEEEEEEKEEEIATGQAFPFTTVETYTVNFGDF
115,sp|P54821|PRRX1_HUMAN,37,77,40,Prediction,HLLDLEEAGDMVAAQADENVGEAGRSLLESPGLTSGSDTP
116,sp|Q7Z3V5|ZN571_HUMAN,10,52,42,Prediction,VAIDFSQEEWECLDPAQRDLYRDVMLENYSNLISLDLESSCV
117,sp|Q3KQV3|ZN792_HUMAN,8,46,38,Prediction,PAQGCVTFEDVTIYFSQEEWVLLDEAQRLLYCDVMLEN
118,sp|Q9HC44|GPBL1_HUMAN,323,417,94,Prediction,EFLKTLKDDRNGDFSENRDCDKLEDLEDNSTPEPKENGEEGCHQNGLALPVVEEGEVLSHSLEAEHRLLKAMGWQEYPENDENCLPLTEDELKE
119,sp|P07199|CENPB_HUMAN,467,509,42,Prediction,SEGLEAEDWAQGVVEAGGSFGAYGAQEEAQCPTLHFLEGGED
120,sp|Q9C0F3|ZN436_HUMAN,87,128,41,Prediction,ENPESEEGFESGDRSERQWGDLTAEEWVSYPLQPVTDLLVH
121,sp|Q96NB3|ZN830_HUMAN,129,169,40,Prediction,AWTTNFDKIGKEFIRATPSKPSGLSLLPDYEDEEEEEEEE
122,sp|Q96NB3|ZN830_HUMAN,325,364,39,Prediction,DEIKNKLKEILTIKELQKKEEENADSDDEGELQDLLSQD
123,sp|Q96BR9|ZBT8A_HUMAN,365,409,44,Prediction,NECLAEFGIDSLPIDLEAEQHLMSPSDGDKDSRWHLSEDENRSY
124,sp|P26358|DNMT1_HUMAN,358,398,40,Prediction,YLDDPDLKYGQHPPDAVDEPQMLTNEKLSIFDANESGFES
125,sp|P26358|DNMT1_HUMAN,544,585,41,Prediction,FTEDSLLRHAQFVVEQVESYDEAGDSDEQPIFLTPCMRDLI
126,sp|P26358|DNMT1_HUMAN,782,879,97,Prediction,WEDSSNGQMFHAHWFCAGTDTVLGATSDPLELFLVDECEDMQLSYIHSKVKVIYKAPSENWAMEGGMDPESLLEGDDGKTYFYQLWYDQDYARFESP
127,sp|Q96JL9|ZN333_HUMAN,179,224,45,Prediction,LQEDKVEEEAMAPGLPTACSQEPVTFADVAVVFTPEEWVFLDSTQ
128,sp|Q13568|IRF5_HUMAN,127,174,47,Prediction,TDSQPPEDYSFGAGEEEEEEEELQRMLPSLSLTEDVKWPPTLQPPTL
129,sp|P86452|ZBED6_HUMAN,324,380,56,Prediction,SGAVANGLDEAETERSDLLSDTLHGEKSTGSQDLTAEDLSDSDSDEPMLEVENRSE
130,sp|P86452|ZBED6_HUMAN,777,816,39,Prediction,LEDFFPQGADLETYKQFLAEEVCNYMESSPEICQIPTSE
131,sp|Q96K83|ZN521_HUMAN,252,293,41,Prediction,EGFDFPEDLQKHIAECHPECSPNEDRAALQCVYCHELFVEE
132,sp|O00716|E2F3_HUMAN,404,465,61,Prediction,NLLQQTEDQIPSNLEGPFVNLLPPLLQEDYLLSLGEEEGISDLFDAYDLEKLPLVEDFMCS
133,sp|Q12778|FOXO1_HUMAN,591,641,50,Prediction,LLHQEKLPSDLDGMFIERLDCDMESIIRNDLMDGDTLDFNFDNVLPNQSF
134,sp|Q68DY9|ZN772_HUMAN,7,124,117,Prediction,GPAQVPMNSEVIVDPIQGQVNFEDVFVYFSQEEWVLLDEAQRLLYRDVMLENFALMASLGHTSFMSHIVASLVMGSEPWVPDWVDMTLAVATETPGGSDPGCWHGMEDEEIPFEQSF
135,sp|Q9ULD9|ZN608_HUMAN,570,608,38,Prediction,RYHQAHAHLDPENKLEFEPDSEDKISDCEEGLSNVALE
136,sp|Q6B0B8|TIGD3_HUMAN,387,425,38,Prediction,SLEEFSRFVDLEGEEPRSGVCKEEIGTEDEKGDREGAF
137,sp|Q969J2|ZKSC4_HUMAN,114,154,40,Prediction,EQHPESGEEVVVLLEYLERQLDEPAPQVPVGDQGQELLCC
138,sp|Q16649|NFIL3_HUMAN,12,50,38,Prediction,QASLDASSNVDKMMVLNSALTEVSEDSTTGEELLLSEG
139,sp|Q8N7U7|TPRX1_HUMAN,342,380,38,Prediction,FLPDTQLFPHFTELLLPLDPLEGSSVSTMTSQYQEGDD
140,sp|Q9BYE7|PCGF6_HUMAN,52,136,84,Prediction,APGCSGSRPPELEPERSLGRFRGRFEDEDEELEEEEELEEEEEEEEEDMSHFSLRLEGGRQDSEDEEERLINLSELTPYILCSI
141,sp|Q8NF99|ZN397_HUMAN,82,154,72,Prediction,LHTKEQILELLVLEQFLSILPEELQIWVQQHNPESGEEAVTLLEDLEREFDDPGQQVPASPQGPAVPWKDLT
142,sp|Q5TGY3|AHDC1_HUMAN,220,298,78,Prediction,AATGLPPEPEPDSTDYSELADADILSELASLTCPEAQLLEAQALEPPSPEPEPQLLDPQPRFLDPQALEPLGEALELP
143,sp|O95785|WIZ_HUMAN,173,283,110,Prediction,VEDTPKTLDMAVVGGREDLEDLEGLAQPSEWGLPTSASEVATQTWTVNSEASVERLQPLLPPIRTGPYLCELLEEVAEGVASPDEDEDEEPAVFPCIECSIYFKQKEHLL
144,sp|O95785|WIZ_HUMAN,557,611,54,Prediction,LGERRRPWSEEEEEEEEEEDVVLTSEMDFSPENGVFSPLATPSLIPQAALELKQ
145,sp|Q9BY31|ZN717_HUMAN,1,51,50,Prediction,LETYNSLVSLQELVSFEEVAVHFTWEEWQDLDDAQRTLYRDVMLETYSSL
146,sp|Q9H8Y5|ANKZ1_HUMAN,105,151,46,Prediction,DKPLLSALDFEKQSSTGDLSSISGSEDSDSASEEDLQTLDRERATF
147,sp|Q9H8Y5|ANKZ1_HUMAN,386,435,49,Prediction,DEKEALGQNEESPKQGSGSEGEDGFQVELELVELTVGTLDLCESEVLPK
148,sp|Q8IUM7|NPAS4_HUMAN,677,802,125,Prediction,GPPVLSLDLKPWKCQELDFLADPDNMFLEETPVEDIFMDLSTPDPSEEWGSGDPEAEGPGGAPSPCNNLSPEDHSFLEDLATYETAFETGVSAFPYDGFTDELHQLQSQVQDSFHEDGSGGEPTF
149,sp|Q6N021|TET2_HUMAN,1819,1857,38,Prediction,SDANGQEKQPLALVQGVASGAEDNDEVWSDSEQSFLDP
150,sp|P98177|FOXO4_HUMAN,461,503,42,Prediction,SQDRMPQDLDLDMYMENLECDMDNIISDLMDEGEGLDFNFEP
151,sp|O43524|FOXO3_HUMAN,598,652,54,Prediction,LPVMGHEKFPSDLDLDMFNGSLECDMESIIRSELMDADGLDFNFDSLISTQNVV
152,sp|Q13398|ZN211_HUMAN,26,86,60,Prediction,DPASGSVTFEDVAVYFSWEEWDLLDEAQKHLYFDVMLENFALTSSLGCWCGVEHEETPSE
153,sp|Q9NX65|ZSC32_HUMAN,70,116,46,Prediction,HSKEEILELLVLEQFLTILPEEIQTWVREQHPENGEEAVALVEDVQ
154,sp|Q8WYP5|ELYS_HUMAN,150,205,55,Prediction,WLFGVAAVVTDVGQILLVDLCLDDLSCNQNEVEASDLEVLTGIPAEVPHIRESVM
155,sp|Q8WYP5|ELYS_HUMAN,1477,1624,147,Prediction,LNQEVALNLKEDHEVEVGVLKESVDLPEEKLPISDSPPDTQEIHVIEQEKLEAQDSGEEARNLSFNELYPSGTLKLQYNFDTIDQQFCDLADNKDTAECDIAEVDGELFVAQSNFTLILEGEEGEVEPGDFASSDVLPKAANTATEE
156,sp|Q7Z340|ZN551_HUMAN,22,79,57,Prediction,RDSAQGMTFEDVAIYFSQEEWELLDESQRFLYCDVMLENFAHVTSLGYCHGMENEAI
157,sp|Q96GC6|ZN274_HUMAN,53,120,67,Prediction,EHQLSKPDVVSQLEEAEDFWPVERGIPQDTIPEYPELQLDPKLDPLPAESPLMNIEVVEVLTLNQEV
158,sp|Q96GC6|ZN274_HUMAN,265,352,87,Prediction,QQEEKQEDAAICPVTVLPEEPVTFQDVAVDFSREEWGLLGPTQRTEYRDVMLETFGHLVSVGWETTLENKELAPNSDIPEEEPAPSL
159,sp|O75541|ZN821_HUMAN,84,127,43,Prediction,EKELENTEQPVGGNEVVEHEVTGNLNSDPLLELCQCPLCQLDC
160,sp|P17014|ZNF12_HUMAN,49,112,63,Prediction,HIIKPDVISKLEQGEEPWIVEGEFLLQSYPDEVWQTDDLIERIQEEENKPSRQTVFIETLIEE
161,sp|Q147U1|ZN846_HUMAN,1,40,39,Prediction,DSSQHLVTFEDVAVDFTQEEWTLLDQAQRDLYRDVMLEN
162,sp|Q9Y2G1|MYRF_HUMAN,7,51,44,Prediction,EALQRFFEGHDINGALEPSNIDTSILEEYISKEDASDLCFPDIS
163,sp|Q7Z591|AKNA_HUMAN,48,156,108,Prediction,NATSPELLEDFRLAQQHLPPLEWDPHPQPDGHQDSESGETSGEEAEAEDVDSPASSHEPLAWLPQQGRQLDMTEEEPDGTLGSLEVEEAGESSSRLGYEAGLSLEGHG
164,sp|Q7Z591|AKNA_HUMAN,199,248,49,Prediction,SWSSGTVSLDHPSDSLDSTWEGETDGPQPTALAETLPEGPSHHLLSPDG
165,sp|P17027|ZNF23_HUMAN,44,87,43,Prediction,LQTDIQTDNDLTKEMYEGKENVSFELQRDFSQETDFSEASLLE
166,sp|O15535|ZSC9_HUMAN,93,146,53,Prediction,LLVLEQFLSILPKELQGWVREHCPESGEEAVILLEDLERELDEPQHEMVAHRH
167,sp|O00409|FOXN3_HUMAN,19,78,59,Prediction,SGLSQCYGGSGFSKALQEDDDLDFSLPDIRLEEGAMEDEELTNLNWLHESKNLLKSFGE
168,sp|Q9NZV7|ZIM2_HUMAN,151,189,38,Prediction,NLPSAGSQFPDFKHLGTFLVFEELVTFEDVLVDFSPEE
169,sp|O60304|ZN500_HUMAN,0,67,67,Prediction,MATVPGLQPLPTLEQDLEQEEILIVKVEEDFCLEEEPSVETEDPSPETFRQLFRLFCYQEVAGPREA
170,sp|O60304|ZN500_HUMAN,138,179,41,Prediction,GSELLSDDEVPLGIGGQFLKHQAEAQPEDLSLEEEARFSSQ
171,sp|Q494X3|ZN404_HUMAN,8,52,44,Prediction,SDVAIDFSQEEWEYLNSDQRDLYRDVMLENYTNLVSLDFNFTTE
172,sp|P10071|GLI3_HUMAN,1056,1121,65,Prediction,SRNFHSSPCPPSITENVTLESLTMDADANLNDEDFLPDDVVQYLNSQNQAGYEQHFPSALPDDSK
173,sp|P10071|GLI3_HUMAN,1492,1532,40,Prediction,SLDSHDLEGVQIDFDAIIDDGDHSSLMSGALSPSIIQNLS
174,sp|Q9Y4E5|ZN451_HUMAN,654,712,58,Prediction,CQDEHDNEIKIKYFCGLCDLIFNVEEAFLSHYEEHHSIDYVFVSEKTETSIKTEDDFP
175,sp|Q9Y4E5|ZN451_HUMAN,852,901,49,Prediction,SLDMEKGVENDLSYQNIEEEIVELPDLDYLRTMTHIVFVDFDNWSNFFG
176,sp|Q96JM3|CHAP1_HUMAN,561,615,54,Prediction,ELPKSALFSESQKAVELGDELQIDAIDDQKCDILVQEELLASPKKLLEDTLFPS
177,sp|Q3ZCX4|ZN568_HUMAN,24,136,112,Prediction,KAWCSQESALSEEEEDTTRPLETVTFKDVAVDLTQEEWEQMKPAQRNLYRDVMLENYSNLVTVGCQVTKPDVIFKLEQEEEPWVMEEEMFGRHCPEVWEVDEQIKKQQETLV
178,sp|P51815|ZN75D_HUMAN,228,276,48,Prediction,PESLSLLTFEDVAVYFSEEEWQLLNPLEKTLYNDVMQDIYETVISLGL
179,sp|Q86W11|ZSC30_HUMAN,0,155,155,Prediction,MSGEATVLAYHAPEEQEGLLVVKVEEENYVLDQDFGLQENPWSQEVFRQKFRQFSYSDSTGPREALSRLRELCCQWLRPEVHSKEQILELLMLEQFLAILPEELQAWLREHRPENGEEAVTMLEELEKELEEPRQQDTTHGQEMFWQEMTSTGAL
180,sp|Q6P1N0|C2D1A_HUMAN,14,64,50,Prediction,AAAARQLGLLVDLSPDGLMIPEDGANDEELEAEFLALVGGQPPALEKLKG
181,sp|Q8NCP5|ZBT44_HUMAN,508,562,54,Prediction,LNHEASELANYFQSSDFLVPDYLNQEQEETLVQYDLGEHGFESNSSVQMPVISQ
182,sp|Q6P2D0|ZFP1_HUMAN,10,57,47,Prediction,TDVTVDFTQEEWEQLDPSQRILYMDVMLENYSNLLSVEVWKADDQME
183,sp|P02788|TRFL_HUMAN,214,255,41,Prediction,FKCLRDGAGDVAFIRESTVFEDLSDEAERDEYELLCPDNTR
184,sp|Q16534|HLF_HUMAN,51,115,64,Prediction,DESNSPTVPQSAFLGPTLWDKTLPYDGDTFQLEYMDLEEFLSENGIPPSPSQHDHSPHPPGLQP
185,sp|Q01826|SATB1_HUMAN,708,761,53,Prediction,NSGLEVDVAEYKEEELLKDLEESVQDKNTNTLFSVKLEEELSVEGNTDINTDL
186,sp|Q96AP4|ZUP1_HUMAN,179,245,66,Prediction,LLDIPLEDCDQPLYDCPMCGLICTNYHILQEHVDLHLEENSFQQGMDRVQCSGDLQLAHQLQQEED
187,sp|B1APH4|ZN487_HUMAN,80,134,54,Prediction,TKPEVVCKLEHGQVLWILEEESPSQSHLDCCIDDDLMEKRQENQDQHLQKVDFV
188,sp|P36508|ZNF76_HUMAN,108,149,41,Prediction,TILAVQTEVGLEDLAAEDDEGFSADAVVALEQYASKVLHDS
189,sp|P15822|ZEP1_HUMAN,462,502,40,Prediction,GLVLQPDAGGLFLSHESPKALSIHSDVEDSGESEEEGATD
190,sp|P43268|ETV4_HUMAN,36,93,57,Prediction,GKLMDPGSLPPLDSEDLFQDLSHFQETWLAEAQVPDSDEQFVPDFHSENLAFHSPTT
191,sp|Q9UIH9|KLF15_HUMAN,111,175,64,Prediction,AAPVKGEHFCLPEFPLGDPDDVPRPFQPTLEEIEEFLEENMEPGVKEVPEGNSKDLDACSQLSA
192,sp|P17040|ZSC20_HUMAN,625,710,85,Prediction,FEMRHEDEDQISEQDIFEGLPGALSKCPTEAVCQPLDWGEDSENENEDEGQWGNPSQEQWQESSSEEDLEKLIDHQGLYLAEKPY
193,sp|Q3SY52|ZIK1_HUMAN,37,83,46,Prediction,QDEWGLLDEAQRLLYLEVMLENFALVASLGCGHGTEDEETPSDQNV
194,sp|O96006|ZBED1_HUMAN,639,694,55,Prediction,HVDEQVFLYENARSGAEAEPEDQDEGEWGLDQEQVFSLGDGVSGGFFGIRDSSFL
195,sp|Q13351|KLF1_HUMAN,41,101,60,Prediction,GPPDPTEPPLHVKSEDQPGEEEDDERGADATWDLDLLLTNFSGPEPGGAPQTCALAPSEA
196,sp|Q9H5V7|IKZF5_HUMAN,40,80,40,Prediction,ALQGAGTDGDQNGLDHPSVEVSLDENSGMLVDGFERTFDG
197,sp|Q9UKD1|GMEB2_HUMAN,214,259,45,Prediction,TIETCEDPGDWTAAIGDDTFTFWRGLKDAGLLDEVIQEFHQELVE
198,sp|Q9Y462|ZN711_HUMAN,103,142,39,Prediction,LEEDDGDHILTSELITETVRVPEQVFVADLVTGPNGHLE
199,sp|Q8TF45|ZN418_HUMAN,16,55,39,Prediction,EEWSLLSEVQRCLYHDVMLENWVLISSLGCWCGSEDEEA
200,sp|Q6P9G9|ZN449_HUMAN,90,149,59,Prediction,REHCPENRERVVSLIEDLQRELEIPEQQVDMHDMLLEELAPVGTAHIPPTMHLESPALQ
201,sp|Q6P9G9|ZN449_HUMAN,264,310,46,Prediction,DYVQLENQWETPPEDLQTDLAKLVDQQNPTLGETPENSNLEEPLNP
202,sp|P50549|ETV1_HUMAN,33,86,53,Prediction,FINRDLAHDSEELFQDLSQLQETWLAEAQVPDNDEQFVPDYQAESLAFHGLPL
203,sp|Q96QS3|ARX_HUMAN,235,326,91,Prediction,DEDEEEELLEDDEEELLEDDARALLKEPRRCPVAATGAVAAAAAAAVATEGGELSPKEELLLHPEDAEGKDGEDSVCLSAGSDSEEGLLKR
204,sp|P49716|CEBPD_HUMAN,47,92,45,Prediction,AAPAMYDDESAIDFSAYIDSMAAVPTLELCHDELFADLFNSNHKA
205,sp|Q05516|ZBT16_HUMAN,78,140,62,Prediction,TFQQILEYAYTATLQAKAEDLDDLLYAAEILEIEYLEEQCLKMLETIQASDDNDTEATMADG
206,sp|O43823|AKAP8_HUMAN,306,346,40,Prediction,QFQLYEEPDTKLARVDSEGDFSENDDAAGDFRSGDEEFKG
207,sp|Q6ZRS2|SRCAP_HUMAN,297,339,42,Prediction,DDEETIEVEEQQEGNDAEAQRREIELLRREGELPLEELLRSL
208,sp|Q6ZRS2|SRCAP_HUMAN,412,461,49,Prediction,EEDTIAAEEQLEGEVDHAMELSELAREGELSMEELLQQYAGAYAPGSGS
209,sp|Q6ZRS2|SRCAP_HUMAN,2605,2682,77,Prediction,APSLTLEAGSIPNGQEQEAPDSAEGTTLTVLPEGEELPLCVSESNGLELPPSAASDEPLQEPLEADRTSEELTEAKT
210,sp|P18848|ATF4_HUMAN,0,141,141,Prediction,MTEMSFLSSEVLVGDLMSPFDQSGLGAEESLGLLDDYLEVAKHFKPHGFSSDKAKAGSSEWLAVDGLVSPSNNSKEDAFSGTDWMLEKMDLKEFDLDALLGIDDLETMPDDLLTTLDDTCDLFAPLVQETNKQPPQTVNPI
211,sp|P42229|STA5A_HUMAN,737,781,44,Prediction,YPQNPDHVLDQDGEFDLDETMDVARHVEELLRRPMDSLDSRLSP
212,sp|Q86YF9|DZIP1_HUMAN,765,808,43,Prediction,GTNVPEMFIKKEELQELKCADVEDEDWDISSLEEEISLGKKSG
213,sp|Q9H2P0|ADNP_HUMAN,731,772,41,Prediction,LDDDSDSPSFFEEKPEEPVVLALDPKGHEDDSYEARKSFLT
214,sp|Q9H2P0|ADNP_HUMAN,859,904,45,Prediction,KTADKKLNLGKEDDSSSDSFENLEEESNESGSPFDPVFEVEPKIS
215,sp|O15516|CLOCK_HUMAN,127,166,39,Prediction,DGSIIYVSESVTSLLEHLPSDLVDQSIFNFIPEGEHSEV
216,sp|P04198|MYCN_HUMAN,8,107,99,Prediction,MPGMICKNPDLEFDSLQPCFYPDEDDFYFGGPDSTPPGEDIWKKFELLPTPPLSPSRGFAEHSSEPPSWVTEMLLENELWGSPAEEDAFGLGGLGGLTP
217,sp|Q15424|SAFB1_HUMAN,153,294,141,Prediction,DNLQESLSDSRELVEGEMKELPEQLQEHAIEDKETINNLDTSSSDFTILQEIEEPSLEPENEKILDILGETCKSEPVKEESSELEQPFAQDTSSVGPDRKLAEEEDLFDSAHPEEGDLDLASESTAHAQSSKADSLLAVVK
218,sp|Q3SYB3|FX4L6_HUMAN,26,75,49,Prediction,IDVLGEEEDEDEVEDEEEAASQQFLEQSLQPGLQVARWGGVALPREHIE
219,sp|O95644|NFAC1_HUMAN,894,932,38,Prediction,LPEVHEDGSPNLAPIPVTVKREPEELDQLYLDDVNEII
220,sp|P01100|FOS_HUMAN,202,252,50,Prediction,ACKIPDDLGFPEEMSVASLDLTGGLPEVATPESEEAFTLPLLNDPEPKPS
221,sp|Q86UZ6|ZBT46_HUMAN,550,589,39,Prediction,DDEGLAPEDALLADDKDEEDSPRPRSPPGGPDKDFAWLS
222,sp|P57073|SOX8_HUMAN,253,299,46,Prediction,SGRQNIDFSNVDISELSSEVMGTMDAFDVHEFDQYLPLGGPAPPEP
223,sp|P18583|SON_HUMAN,131,182,51,Prediction,QPEESESKTKSHDDGNIDLESDSFLKFDSEPSAVALELPTRAFGPSETNES
224,sp|P18583|SON_HUMAN,2116,2155,39,Prediction,EDDDVIVNKPHVSDEEEEEPPFYHHPFKLSEPKPIFFNL
225,sp|P17947|SPI1_HUMAN,32,80,48,Prediction,HEYYPYLSSDGESHSDHYWDFHPHHVHSEFESFAENNFTELQSVQPPQ
226,sp|Q8N7M2|ZN283_HUMAN,67,121,54,Prediction,MTDGLVTFRDVAIDFSQEEWECLDPAQRDLYVDVMLENYSNLVSLDLESKTYET
227,sp|Q9Y483|MTF2_HUMAN,506,556,50,Prediction,ALQTQNSEIVKDDEGKEDYQFDELNTEILNNLADQELQLNHLKNSITSYF
228,sp|Q03164|KMT2A_HUMAN,1876,1918,42,Prediction,LTYGDDSANDAGRLLYIGQNEWTHVNCALWSAEVFEDDDGSL
229,sp|Q03164|KMT2A_HUMAN,2668,2707,39,Prediction,DDLSTSDEDDLYYYNFTRTVISSGGEERLASHNLFREEE
230,sp|Q03164|KMT2A_HUMAN,2887,2933,46,Prediction,EKDMGLFEVFSQQLPTTEPVDSSVSSSISAEEQFELPLELPSDLSV
231,sp|Q9UJL9|ZF69B_HUMAN,48,88,40,Prediction,ADETQGESLESRVTLGSLTAESQELLTFKDVSVDFTQEEW
232,sp|Q5VV16|FX4L5_HUMAN,26,75,49,Prediction,IDVLGEEEDEDEVEDEEEEARQQFLEQSLQPGLQVARWGGVALPREHIE
233,sp|Q96JG9|ZN469_HUMAN,817,870,53,Prediction,PSLAATPFPLPASDLDMEDDAKLDSLITEALNGMEYQSDNPEIDSSFIDVFAD
234,sp|Q96JG9|ZN469_HUMAN,2861,2933,72,Prediction,PTQPSFEEGGDPTLGPARLPTDLSDSSSLCLCHEDPWEDEDPAGLPESFLLDGFLNSRVPGIDPWAPGLSLW
235,sp|P20823|HNF1A_HUMAN,51,114,63,Prediction,GGRGELAELPNGLGETRGSEDETDDDGEDFTPPILKELENLSPEEAAHQKAVVETLLQEDPWR
236,sp|Q8N196|SIX5_HUMAN,696,739,43,Prediction,PDPDPEGLLLGATAGGEVDEGLEAEAKVLTQLQSVPVEEPLEL
237,sp|Q8IX15|HOMEZ_HUMAN,482,527,45,Prediction,QLSQASRLSTQQVLDWFDSRLPQPAEVVVCLDEEEEEEEEELPED
238,sp|Q9Y2L8|ZKSC5_HUMAN,10,134,124,Prediction,DLDPPAETSQEQEDLFIVKVEEEDCTWMQEYNPPTFETFYQRFRHFQYHEASGPREALSQLRVLCCEWLRPELHTKEQILELLVLEQFLTILPEEFQPWVREHHPESGEEAVAVIENIQRELEE
239,sp|Q86VK4|ZN410_HUMAN,132,180,48,Prediction,SSAEHLVFVQDEAEDSGNDFLSSESTDSSIPWFLRVQELAHDSLIAAT
240,sp|A8MZ59|LEUTX_HUMAN,137,198,61,Prediction,SQSYDIEQICLGASNPPWASTLFEIDEFVKIYDLPGEDDTSSLNQYLFPVCLEYDQLQSSV
241,sp|Q9Y222|DMTF1_HUMAN,331,380,49,Prediction,KQSGGTEWTKEDEINLILRIAELDVADENDINWDLLAEGWSSVRSPQWL
242,sp|Q8N587|ZN561_HUMAN,19,83,64,Prediction,EEKTKVERMVEDYLASGYQDSVTFDDVAVDFTPEEWALLDTTEKYLYRDVMLENYMNLASVEWE
243,sp|O15391|TYY2_HUMAN,62,132,70,Prediction,QPLFTNTGYGDHDQEMLMLQTQEEVVGYCDSDNQLGNDLEDQLALPDSIEDEHFQMTLASLSASAASTST
244,sp|Q86UP8|GTD2A_HUMAN,544,582,38,Prediction,VAYSIAIDEITDINNTTQLAIFIRGVDENFDVSEELLD
245,sp|Q8WTR7|ZN473_HUMAN,0,152,152,Prediction,MAEEFVTLKDVGMDFTLGDWEQLGLEQGDTFWDTALDNCQDLFLLDPPRPNLTSHPDGSEDLEPLAGGSPEATSPDVTETKNSPLMEDFFEEGFSQEIIEMLSKDGFWNSNFGEACIEDTWLDSLLGDPESLLRSDIATNGESPTECKSHEL
246,sp|P54274|TERF1_HUMAN,44,97,53,Prediction,LECQVQVGAPEEEEEEEEDAGLVAEAEAVAAGWMLDFLCLSLCRAFRDGRSED
247,sp|Q96MX3|ZNF48_HUMAN,37,85,48,Prediction,NEFEHTPQEDDLGFKEEDLAPDHEVGNASLKPEGIQNWDDLWVQREGL
248,sp|Q96N77|ZN641_HUMAN,56,96,40,Prediction,PLEHLCCDLEEEPQSLQEKAQSAPWVPAIPQEGNTGDWEM
249,sp|Q96N77|ZN641_HUMAN,153,194,41,Prediction,PKLDMLSQLEGGEEQWVPDPQDLEERDILRVTYTGDGSEHE
250,sp|Q9Y4A0|JERKL_HUMAN,142,183,41,Prediction,ERLNGDETAVEDFCNNFRDFIERENLQPEQIYNADETGLFW
251,sp|Q9Y4A0|JERKL_HUMAN,453,503,50,Prediction,QGQADESSENEEEEIELIPEKHINHAAALQWTENLLDYLEQQGDMILPDR
252,sp|Q9NR83|S2A4R_HUMAN,220,274,54,Prediction,IRLVHLGRQAEPEQSDGEEDFYYTELDVGVDTLTDGLSSLTPVSPTASMPPAFP
253,sp|Q03701|CEBPZ_HUMAN,7,92,85,Prediction,LEFHAKRPWRPEEAVEDPDEEDEDNTSEAENGFSLEEVLRLGGTKQDYLMLATLDENEEVIDGGKKGAIDDLQQGELEAFIQNLN
254,sp|Q03701|CEBPZ_HUMAN,602,644,42,Prediction,CGALYLVSEILKAKPGLRSQLDDHPESDDEENFIDANDDEDM
255,sp|Q3MJ62|ZSC23_HUMAN,94,140,46,Prediction,QFLTILPEELQAWVRQHRPVSGEEAVTVLEDLERELDDPGEQVLSH
256,sp|Q9UBX2|DUX4_HUMAN,365,424,59,Prediction,SALPCGLLLDELLASPEFLQQAQPLLETEAPGELEASEEAASLEAPLSEEEYRALLEEL
257,sp|P36402|TCF7_HUMAN,13,61,48,Prediction,GDDLGAPDELLAFQDEGEEQDDKSRDSAAGPERDLAELKSSLVNESEG
258,sp|P19532|TFE3_HUMAN,257,298,41,Prediction,EKEIDDVIDEIISLESSYNDEMLSYLPGGTTGLQLPSTLPV
259,sp|P19532|TFE3_HUMAN,488,550,62,Prediction,HQQPPAPPSDALLDLHFPSDHLGDLGDPFHLGLEDILMEEEEGVVGGLSGGALSPLRAASDP
260,sp|O15015|ZN646_HUMAN,335,374,39,Prediction,HTDESSQDQLPSAQMLNGSAELSTSGELEDSGLEEYRPF
261,sp|O15015|ZN646_HUMAN,685,797,112,Prediction,EAKLLAAESWTRELEDNEGLESPQDPSGESPHGAEGNLESDGDCLQAESEGDKCGLERDETHFQGDKESGGTGEGLERKDASLLDNLDIPGEEGGGTHFCDSLTGVDEDQKP
262,sp|O15015|ZN646_HUMAN,912,954,42,Prediction,SEEEGEEEGVAEAAPARSPPLQLSEAELLNQLQREVEALDSA
263,sp|Q99814|EPAS1_HUMAN,68,116,48,Prediction,LLSSVCSENESEAEADQQMDNLYLKALEGFIAVVTQDGDMIFLSENIS
264,sp|Q99814|EPAS1_HUMAN,485,561,76,Prediction,EDYYTSLDNDLKIEVIEKLFAMDTEAKDQCSTQTDFNELDLETLAPYIPMDGEDFQLSPICPEERLLAENPQSTPQ
265,sp|Q9NR48|ASH1L_HUMAN,907,951,44,Prediction,LSVAPFVATESPSKLESESDNHRSSSDFFESEDQLQDPDDLDDS
266,sp|Q9NR48|ASH1L_HUMAN,2844,2889,45,Prediction,ERSKPPLKDLGQEDDALPLIEEVLASQEQAANEIPSLEEPEREGA
267,sp|Q9UID6|ZN639_HUMAN,277,344,67,Prediction,HIADTHFSDHLYWCEQCDVQFSSSSELYLHFQEHSCDEQYLCQFCEHETNDPEDLHSHVVNEHACKL
268,sp|Q7Z570|Z804A_HUMAN,879,917,38,Prediction,SFHPNNLLPSETNGETEHLEMETTSGELSDVSNDPTTS
269,sp|P31629|ZEP2_HUMAN,250,288,38,Prediction,TESAVSKLDLEAGFIDVEAEIHSDGEQSTDTDEESSLF
270,sp|Q15788|NCOA1_HUMAN,914,952,38,Prediction,ELLCPPTTVEGRNDEKALLEQLVSFLSGKDETELAELD
271,sp|Q8TBC5|ZSC18_HUMAN,201,239,38,Prediction,AKTEEDGPANTEQKLKSFPEDPQHLGEWGHLDPAEENL
272,sp|P51692|STA5B_HUMAN,743,786,43,Prediction,PQNPDSVLDTDGDFDLEDTMDVARRVEELLGRPMDSQWIPHAQ
273,sp|Q9H4T2|ZSC16_HUMAN,87,125,38,Prediction,QFLSILPKDLQAWVRAHHPETGEEAVTVLEDLERELDE
274,sp|Q9H5H4|ZN768_HUMAN,48,88,40,Prediction,YEVEEIPFGLEPQSPGFEPQSPEFEPQSPRFEPESPGFES
275,sp|Q6NUN9|ZN746_HUMAN,190,234,44,Prediction,EGELQLQEQQALGVEAWAAGQPDIGEEPWGLSQLDSGAGDISTD
276,sp|Q49AA0|ZFP69_HUMAN,24,98,74,Prediction,AVEGAPLWEDVTKMFEGEALLSQDAEDVKTQRESLEDEVTPGLPTAESQELLTFKDISIDFTQEEWGQLAPAHQ
277,sp|Q8TE12|LMX1A_HUMAN,319,362,43,Prediction,QMPGDHMHPYGAEPLFHDLDSDDTSLSNLGDCFLATSEAGPLQ
278,sp|Q14919|NC2A_HUMAN,66,105,39,Prediction,TSHLKQCIELEQQFDFLKDLVASVPDMQGDGEDNHMDGD
279,sp|Q14919|NC2A_HUMAN,165,205,40,Prediction,SAHFQSPPTPFLPFASTLPLPPAPPGPSAPDEEDEEDYDS
280,sp|Q8ND82|Z280C_HUMAN,7,56,49,Prediction,QPKNISKMAELFMECEEEELEPWQKKVEETQDEDDDELIFVGEISSSKP
281,sp|P0CG23|ZN853_HUMAN,280,418,138,Prediction,QQQEQLQQQQQQQLLQQQQEQLQQQQLQPPPLEPEEEEEVELELMPVDLGSEQELEQQRQELERQQELERQQEQRQLQLKLQEELQQLEQQLEQQQQQLEQQEVQLELTPVELGAQQQEVQLELTPVQPELQLELVPA
282,sp|Q16621|NFE2_HUMAN,118,165,47,Prediction,PLQDPLALLDIGLPAGPPKPQEDPESDSGLSLNYSDAESLELEGTEA
283,sp|Q99607|ELF4_HUMAN,1,118,117,Prediction,AITLQPSDLIFEFASNGMDDDIHQLEDPSVFPAVIVEQVPYPDLLHLYSGLELDDVHNGIITDGTLCMTQDQILEGSFLLTDDNEATSHTMSTAEVLLNMESPSDILDEKQIFSTSE
284,sp|Q9HAZ2|PRD16_HUMAN,199,241,42,Prediction,IEPGEELLVHVKEGVYPLGTVPPGLDEEPTFRCDECDELFQS
285,sp|Q9HAZ2|PRD16_HUMAN,1153,1193,40,Prediction,EDEEDEEPAASLAVGFDHTRRCAEDHEGGLLALEPMPTFG
286,sp|Q9H0M5|ZN700_HUMAN,11,49,38,Prediction,DPGTSESREMDPVAFEDVAVNFTQEEWTLLDISQKNLF
287,sp|Q96LU7|MRFL_HUMAN,1,46,45,Prediction,DVVGENEALQQFFEAQGANGTLENPALDTSLLEEFLGNDFDLGAL
288,sp|Q6ZS27|ZN662_HUMAN,93,131,38,Prediction,DFILKEEIIEEAQDLMVLSSGPQWCGSQELWFGKTCEE
289,sp|Q70SY1|CR3L2_HUMAN,4,59,55,Prediction,ESGEQGVLQWDRKLSELSEPGDGEALMYHTHFSELLDEFSQNVLGQLLNDPFLSE
290,sp|Q8N859|ZN713_HUMAN,53,146,93,Prediction,NLVALGYQLCKPEVIAQLELEEEWVIERDSLLDTHPDGENRPEIKKSTTSQNISDENQTHEMIMERLAGDSFWYSILGGLWDFDYHPEFNQEN
291,sp|Q10587|TEF_HUMAN,89,130,41,Prediction,DGESFHLEYMDLDEFLLENGIPASPTHLAHNLLLPVAELEG
292,sp|Q96DT7|ZBT10_HUMAN,57,106,49,Prediction,PNGRGADEEVELEGLEPQDLEASAGPAAGAAEEAKELLLPQDAGGPTSL
293,sp|Q96DT7|ZBT10_HUMAN,149,201,52,Prediction,LRHFNGRGPATVDLELDALEGKELMQDGASLSDSTEDEEEGASLGDGSGAEG
294,sp|Q96DT7|ZBT10_HUMAN,588,634,46,Prediction,PPNNETNLEDCSVMQPPVAYPEENTLLIKEEPDLDGALLSGPDGDR
295,sp|P04637|P53_HUMAN,19,70,51,Prediction,SDLWKLLPENNVLSPLPSQAMDDLMLSPDDIEQWFTEDPGPDEAPRMPEAA
296,sp|Q5T5D7|ZN684_HUMAN,1,41,40,Prediction,ISFQESVTFQDVAVDFTAEEWQLLDCAERTLYWDVMLENY
297,sp|O15060|ZBT39_HUMAN,266,320,54,Prediction,VDITTGTNSCLSNSEHSKDPGFGQMDELQLEDLGDDDLQFEDPAEDIGTTEEVI
298,sp|Q7Z7L9|ZSCA2_HUMAN,100,162,62,Prediction,MLPKEIQAWLQEHRPESSEEAAALVEDLTQTLQDSDFEIQSENGENCNQDMFENESRKIFSE
299,sp|Q8N3X6|LCORL_HUMAN,49,110,61,Prediction,CVGFESILEGLYGPRLRRDLSLFEDCEPEELTDWSMDEKCSFCNLQREAVSDCIPSLDSSQ
300,sp|Q96MM3|ZFP42_HUMAN,54,104,50,Prediction,CYEPGPQALGGDDFSDCYIECVIRGEFSQPILEEDSLFESLEYLKKGSEQ
301,sp|O95718|ERR2_HUMAN,347,387,40,Prediction,ALANSDSMYIEDLEAVQKLQDLLHEALQDYELSQRHEEPW
302,sp|Q96H12|MSD3_HUMAN,113,159,46,Prediction,MLPEQLYFLQSPPEEEPEYHPDASAQESFAVSNRELCDDEKEFIHF
303,sp|P01106|MYC_HUMAN,86,135,49,Prediction,DGGGGSFSTADQLEMVTELLGGDMVNQSFICDPDDETFIKNIIIQDCMW
304,sp|Q8N8E2|ZN513_HUMAN,7,84,77,Prediction,HPQPVKCEGVKVDTEDSLDEGPGALVLESDLLLGQDLEFEEEEEEEEGDGNSDQLMGFERDSEGDSLGARPGLPYGL
305,sp|Q14592|ZN460_HUMAN,144,185,41,Prediction,SPEDALYGFDSYGPVTDSLIHEGENSYKFEEMFNENCFLVQ
306,sp|P35638|DDIT3_HUMAN,1,67,66,Prediction,AAESLPFSFGTLSSWELEAWYEDLQEVLSSDENGGTYVSPPGNEEEESKIFTTLDPASLAWLTEEE
307,sp|Q3KNS6|ZN829_HUMAN,12,77,65,Prediction,WCHPEEEERMHDELLQAVSKGPVMFRDVSIDFSQEEWECLDADQMNLYKEVMLENFSNLVSVGLS
308,sp|Q13129|RLF_HUMAN,403,520,117,Prediction,EDLEVRRACQLTEFLIEPSLDGFNMLEELYLQPDQKFDEENAPVPNSLRCELLLALKAHWPFDPEFWDWKTLKRHCHQLLGQEASDSDDDLSGYEMSINDTDVLESFLSDYDEGKED
309,sp|Q13129|RLF_HUMAN,1757,1814,57,Prediction,SFDLKTYKPMGFESSFLKFIQESEEKEDDFDDWEPSEHLTLSNSSQSSNDLTGNVVA
310,sp|P10244|MYBB_HUMAN,294,354,60,Prediction,EAANLLIPAVGSSLSEALDLIESDPDAWCDLSKFDLPEEPSAEDSINNSLVQLQASHQQQ
311,sp|Q06945|SOX4_HUMAN,381,471,90,Prediction,ASSHSSSSSSSGSSSSDDEFEDDLLDLNPSSNFESMSLGSFSSSSALDRDLDFNFEPGSGSHFEFPDYCTPEVSEMISGDWLESSISNLV
312,sp|Q9ULJ3|ZBT21_HUMAN,495,546,51,Prediction,KLKVNEHGSPVSEDNFEEGSSPTLLDADFPDSDLNKDEFGELEGTRPNKKF
313,sp|Q9ULJ3|ZBT21_HUMAN,842,885,43,Prediction,DDNVFSDSSEQVNFDSEDSSCLPEDLSLSKQLKIQVKEEPVEE
314,sp|Q6P9A3|ZN549_HUMAN,38,77,39,Prediction,EEWGLLDEAQRCLYHDVMLENFSLMASVGCLHGIEAEEA
315,sp|Q7Z353|HDX_HUMAN,635,690,55,Prediction,LILAMKADDKEQQQALLSDLPPELEEMDFNHASLEPDDTSFSVSSLSEKNVSESL
316,sp|Q9HAP2|MLXIP_HUMAN,235,286,51,Prediction,HKDEDLSSLVQDDDMLYWHKHGDGWKTPVPMEEDPLLDTDMLMSEFSDTLF
317,sp|Q8IZM8|ZN654_HUMAN,302,344,42,Prediction,ECHELFEDLPLLYEHEAQHYLSKTPESSAQPSETILWDVQTD
318,sp|O43151|TET3_HUMAN,1466,1537,71,Prediction,LWDPFSLEEGPAEEPPSKGAVKEEKGGGGAEEEEEELWSDSEHNFLDENIGGVAVAPAHGSILIECARREL
319,sp|Q3C1V8|BSH_HUMAN,195,233,38,Prediction,TAAEARLSLPAGPFVLTEPEDEVDIGDEGELGSGPHVL
320,sp|Q06330|SUH_HUMAN,202,244,42,Prediction,LHVEGGNFHASSQQWGAFFIHLLDDDESEGEEFTVRDGYIHY
321,sp|Q9H2A3|NGN2_HUMAN,3,52,49,Prediction,KSETLELKEEEDVLVLLGSASPALAALTPLSSSADEEEEEEPGASGGAR
322,sp|Q8N5A5|ZGPAT_HUMAN,250,288,38,Prediction,DSLLLREAVVEGDGILPPLRTEATESDSDSDGTGDSSY
323,sp|P49910|ZN165_HUMAN,81,139,58,Prediction,IHTKEQILELLVLEQFLTILPGDLQAWVHEHYPESGEEAVTILEDLERGTDEAVLQVQ
324,sp|Q8NA19|LMBL4_HUMAN,214,254,40,Prediction,ADIVEDRLLVHFDNWDDSYDYWCDVNSPYVQPVGWCQENG
325,sp|Q96MU6|ZN778_HUMAN,18,83,65,Prediction,LHEEQTQAAGMVAGWLINCYQDAVTFDDVAVDFTQEEWTLLDPSQRDLYRDVMLENYENLASVEW
326,sp|O43298|ZBT43_HUMAN,147,195,48,Prediction,YNGLVESFELGSGGHTDFPKAQELRDGENEEESTKDELSSQLTEHEYL
327,sp|Q9BX82|ZN471_HUMAN,85,142,57,Prediction,DWESIYVTQELPLKQFMYDDACMEGITSYGLECSTFEENWKWEDLFEKQMGSHEMFS
328,sp|Q96LW9|ZSC31_HUMAN,70,126,56,Prediction,EIHTKEQILELLVLEQFLTILPEELQAWVREHHPESGEEAVAVVEDLEQELSEPGN
329,sp|Q96LW9|ZSC31_HUMAN,165,204,39,Prediction,YESFCLHQFQEQDGESIPENQELASKQEILKEMEHLGDS
330,sp|Q00653|NFKB2_HUMAN,242,282,40,Prediction,GDEVYLLCDKVQKDDIEVRFYEDDENGWQAFGDFSPTDVH
331,sp|P78413|IRX4_HUMAN,228,297,69,Prediction,GGEEEAREEPLKSSKNAEPVGKEEKELELSDLDDFDPLEAEPPACELKPPFHSLDGGLERVPAAPDGPV
332,sp|Q9BZI1|IRX2_HUMAN,258,301,43,Prediction,KYDDLEDDEDDDEEGERGLAPPKPVTSSPLTGLEAPLLSPPPE
333,sp|O60663|LMX1B_HUMAN,154,193,39,Prediction,EFVLKEGQLLCKGDYEKEKDLLSSVSPDESDSVKSEDED
334,sp|Q9H582|ZN644_HUMAN,321,362,41,Prediction,EVDFLEQNEELQAVDSQKYALSKVKPESTDEDLESVDAFQH
335,sp|Q9H582|ZN644_HUMAN,854,949,95,Prediction,TEDESSWDNVELGDYTTQAIEDETYSDINQEHVNLFPLFKSKVEGQEPGENATLSYDQNDGFYFEYYEDTGSNNFLHEIHDPQHLETADASLSKH
336,sp|P78545|ELF3_HUMAN,127,179,52,Prediction,LTSSSSDELSWIIELLEKDGMAFQEALDPGPFDQGSPFAQELLDDGQQASPY
337,sp|P51814|ZNF41_HUMAN,149,199,50,Prediction,QGIPGGIFFHCERFDQPIGEDSLCSILEELWQDNDQLEQRQENQNNLLSH
338,sp|O14978|ZN263_HUMAN,79,120,41,Prediction,ILELLVLEQFLTILPQEIQSRVQELHPESGEEAVTLVEDMQ
339,sp|O14978|ZN263_HUMAN,191,234,43,Prediction,SAPWLSLFPPEGNMEDKEMTGPQLPESLEDVAMYISQEEWGHQ
340,sp|Q14765|STAT4_HUMAN,14,54,40,Prediction,LEQVDQFYDDNFPMEIRHLLAQWIENQDWEAASNNETMAT
341,sp|O43364|HXA2_HUMAN,206,257,51,Prediction,NQNSEGKCKSLEDSEKVEEDEEEKTLFEQALSVSGALLEREGYTFQQNALS
342,sp|Q15596|NCOA2_HUMAN,774,835,61,Prediction,PASNTKLIAMKTEKEEMSFEPGDQPGSELDNLEEILDDLQNSQLPQLFPDTRPGAPAGSVD
343,sp|Q15596|NCOA2_HUMAN,1056,1128,72,Prediction,GSSPDDLLCPHPAAESPSDEGALLDQLYLALRNFDGLEEIDRALGIPELVSQSQAVDPEQFSSQDSNIMLEQ
344,sp|Q96E29|MTEF3_HUMAN,90,149,59,Prediction,MNEQSQKTQNISSFDSELFLEELDELPPLSPMQPISEEEAIQIIADPPLPPASFTLRDY
345,sp|Q14929|ZN169_HUMAN,62,102,40,Prediction,IEQLEQGDEPWREENEHLLDLCPEPRTEFQPSFPHLVAFS
346,sp|Q8NCY6|MSD4_HUMAN,91,196,105,Prediction,VGSGFPLPSSDLDDSLTEEIDEKIGFRNDANFDWQNVADFRDAGGSLTEVKVEEEERDPQSPEFEIEEEEEMLSSVIPDSRRENELPDFPHIDEFFTLNSTPSRS
347,sp|Q07869|PPARA_HUMAN,1,58,57,Prediction,VDTESPLCPLSPLEAGDLESPLSEEFLQEMGNIQEISQSIGEDSSGSFGFTEYQYLG
348,sp|Q96KN3|PKNX2_HUMAN,95,136,41,Prediction,GSECITSASFDVDIENFVHQQEQEHKPFFSDDPELDNLMVK
349,sp|Q9UC07|ZNF69_HUMAN,11,49,38,Prediction,DPGTSESQEMDPVAFDDVAVNFTQEEWALLDISQRKLY
350,sp|Q8WW38|FOG2_HUMAN,25,78,53,Prediction,ECPSEETDIISKGDFPLEESFSTEFGPENLSCEEVEYFCNKGDDEGIQETAES
351,sp|Q6XYB7|LBX2_HUMAN,160,198,38,Prediction,VLCSLALPEGAPDPGLCLGPAGPDSRPHLSDEEIQVDD
352,sp|Q12968|NFAC3_HUMAN,116,161,45,Prediction,SPNCHQELDAHEDDLQINDPEREFLERPSRDHLYLPLEPSYRESS
353,sp|Q9Y692|GMEB1_HUMAN,222,286,64,Prediction,EEAGLEWNSALTAAVTMATEEGVKKDSEEISEDTLMFWKGIADVGLMEEVVCNIQKEIEELLRG
354,sp|Q8IWI9|MGAP_HUMAN,354,394,40,Prediction,CLIASSFEDDSRVASPLDQNGSFNVVIKEEPLDDYDYELG
355,sp|Q8IWI9|MGAP_HUMAN,645,695,50,Prediction,PGSTFPDVKPDLEDVDGVLFVSFESKEALDIHAVDGTTEESSSLQASTTN
356,sp|Q8IWI9|MGAP_HUMAN,2271,2310,39,Prediction,GHLLLPGEQIQPKQEKKGGRSSADFTVLDLEEDDEDDNE
357,sp|Q8IWI9|MGAP_HUMAN,2787,2942,155,Prediction,IEMELRKVTSAIEEAALDSSELLTNMEDEDDTDETLTSLLNEIAFLNQQLNDDSVGLAELPSSMDTEFPGDARRAFISKVPPGSRATFQVEHLGTGLKELPDVQGESDSISPLLLHLEDDDFSENEKQLAEPASEPDVLKIVIDSEIKDSLLSNK
358,sp|Q8NAP8|ZBT8B_HUMAN,231,271,40,Prediction,EFDADEVEVDVGEQLQQYAAPLNLAHVEEALPSGQAVDLA
359,sp|Q8NAP8|ZBT8B_HUMAN,414,453,39,Prediction,LRRFGLCDSCTCVTDTPDDDDDLMPINLSLVEASSESQE
360,sp|Q00577|PURA_HUMAN,189,228,39,Prediction,LPAQGLIEFRDALAKLIDDYGVEEEPAELPEGTSLTVDN
361,sp|Q8N720|ZN655_HUMAN,17,58,41,Prediction,QSLETQSECLSPEPQFVQDTDMEQGLTGDGETREENKLLIP
362,sp|Q14653|IRF3_HUMAN,114,155,41,Prediction,GDFSQPDTSPDTNGGGSTSDTQEDILDELLGNMVLAPLPDP
363,sp|Q15714|T22D1_HUMAN,139,186,47,Prediction,DLDESHTEDLSSSEILDVSLSRATDLGEPERSSSEETLNNFQEAETP
364,sp|Q92949|FOXJ1_HUMAN,0,53,53,Prediction,MAESWLRLSGAGPAEEAGPEGGLEEPDALDDSLTSLQWLQEFSILNAKAPALP
365,sp|Q92949|FOXJ1_HUMAN,289,411,122,Prediction,STLLPTPEEQGELEPLKGNFDWEAIFDAGTLGGELGALEALELSPPLSPASHVDVDLTIHGRHIDCPATWGPSVEQAADSLDFDETFLATSFLQHPWDESGSGCLPPEPLFEAGDATLASDL
366,sp|P15036|ETS2_HUMAN,28,68,40,Prediction,FDTFDGSLFAVFPSLNEEQTLQEVPTGLDSISHDSANCEL
367,sp|P15036|ETS2_HUMAN,141,191,50,Prediction,LGKERFLELAPDFVGDILWEHLEQMIKENQEKTEDQYEENSHLTSVPHWI
368,sp|P15036|ETS2_HUMAN,278,318,40,Prediction,PENGADSFESSDSLLQSWNSQSSLLDVQRVPSFESFEDDC
369,sp|P98169|ZXDB_HUMAN,85,128,43,Prediction,GGGGDDFFLVLLDPVGGDVETAGSGQAAGPVLREEAEEGPGLQ
370,sp|Q8TEK3|DOT1L_HUMAN,121,172,51,Prediction,PEKLNNYEPFSPEVYGETSFDLVAQMIDEIKMTDDDLFVDLGSGVGQVVLQ
371,sp|Q14494|NF2L1_HUMAN,117,292,175,Prediction,PNSGLALESSSGLQDVTGPDNGVRESETEQGFGEDLEDLGAVAPPVSGDLTKEDIDLIDILWRQDIDLGAGREVFDYSHRQKEQDVEKELRDGGEQDTWAGEGAEALARNLLVDGETGESFPAQVPSGEDQTALSLEECLRLLEATCPFGENAEFPADISSITEAVPSESEPPAL
372,sp|Q14494|NF2L1_HUMAN,415,497,82,Prediction,LFFPPQLNGTANDTAGPELPDPLGGLLDEAMLDEISLMDLAIEEGFNPVQASQLEEEFDSDSGLSLDSSHSPSSLSSSEGSS
373,sp|P10276|RARA_HUMAN,315,359,44,Prediction,LLPLEMDDAETGLLSAICLICGDRQDLEQPDRVDMLQEPLLEAL
374,sp|Q8WY36|BBX_HUMAN,23,68,45,Prediction,KCLQWHPLLAKKLLDFSEEEEEEDEEEDIDKVQLLGADGLEQDVG
375,sp|Q4VC44|FWCH1_HUMAN,211,251,40,Prediction,VEEPLEGVGPWQCPEEPEPTPGLVLSKPALEEEEAPRALS
376,sp|Q4VC44|FWCH1_HUMAN,392,436,44,Prediction,KVEDQELPTQPEAPDEHQDMDADPGGPEFLKTPLGGSFLVYESF
377,sp|P08151|GLI1_HUMAN,207,249,42,Prediction,QDPLLGMLDGREDLEREEKREPESVYETDCRWDGCSQEFDSQ
378,sp|P08151|GLI1_HUMAN,1027,1067,40,Prediction,PPEGQVCNPLDSLDLDNTQLDFVAILDEPQGLSPPPSHDQ
379,sp|O43889|CREB3_HUMAN,0,60,60,Prediction,MELELDAGDQDLLAFLLEESGDLGTAPDEAVRAPLDWALPLSEVPSDWEVDDLLCSLLSP
380,sp|O43889|CREB3_HUMAN,109,148,39,Prediction,EELAEQEIARLVLTDEEKSLLEKEGLILPETLPLTKTEE
381,sp|Q96IT1|ZN496_HUMAN,115,179,64,Prediction,AVEALEREPGRPWQWLKHCEDPVVIDDGDSPLDQEQEQLPVEPHSDLAKNQDAQPITLAQCLGL
382,sp|Q96IT1|ZN496_HUMAN,224,275,51,Prediction,DMILCFSEEDWSLLDPAQTGFYGEFIIGEDYGVSMPPNDLAAQPDLSQGEE
383,sp|P78415|IRX3_HUMAN,242,289,47,Prediction,EGLADDDEDEEIDLENLDGAATEPELSLAGAARRDGDLGLGPISDSK
384,sp|Q96MW7|TIGD1_HUMAN,410,495,85,Prediction,IDDYEGFKTSVEEVSADVVEIAKELELEVEPEDVTELLQSHDKTLTDEELFLMDAQRKWFLEMESTPGEDAVNIVEMTTKDLEYY
385,sp|Q14934|NFAC4_HUMAN,0,47,47,Prediction,MGAASCEDEELEFKLVFGEEKEAPPLGAGGLGEELDSEDAPPCCRLA
386,sp|Q14934|NFAC4_HUMAN,165,207,42,Prediction,FFSPSPGSSSLSSWSFFSDASDEAALYAACDEVESELNEAAS
387,sp|P52630|STAT2_HUMAN,695,783,88,Prediction,IVVSNRQVDELQQPLELKPEPELESLELELGLVPEPELSLDLEPLLKAGLDLGPELESVLESTLEPVIEPTLCMVSQTVPEPDQGPVS
388,sp|Q8NDW4|ZN248_HUMAN,64,102,38,Prediction,EPWILEKGFPSQCHPERKWKVDDVLESSQENEDDHFWE
389,sp|Q49AM1|MTEF2_HUMAN,65,106,41,Prediction,KGWVLLEDETYVEEIANILQELGADETAVASILERCPEAIV
390,sp|P41161|ETV5_HUMAN,28,86,58,Prediction,DRKRKFLDTDLAHDSEELFQDLSQLQEAWLAEAQVPDDEQFVPDFQSDNLVLHAPPPT
391,sp|P41161|ETV5_HUMAN,449,510,61,Prediction,DPDALFSMAFPDNQRPFLKAESECHLSEEDTLPLTHFEDSPAYLLDMDRCSSLPYAEGFAY
392,sp|Q9UL36|ZN236_HUMAN,812,882,70,Prediction,AANPEAMLDLEPQHVVGTEEAGLGQQLADQPLEADEDGFVAPQDPLRGHVDQFEEQSPAQQSFEPAGLPQ
393,sp|Q9UL36|ZN236_HUMAN,922,961,39,Prediction,LQAPSSDGMNVTTRLIQESSQEELDLQAQGSQFLEDNED
394,sp|Q9UL36|ZN236_HUMAN,1802,1845,43,Prediction,YAGALQESAGHPEQDGEELSRTLHLEEVVQEAAGEWQALTHVF
395,sp|Q14151|SAFB2_HUMAN,117,293,176,Prediction,ASLENLQNMGMMDMSVLDETEVANSSAPDFGEDGTDGLLDSFCDSKEYVAAQLRQLPAQPPEHAVDGEGFKNTLETSSLNFKVTPDIEESLLEPENEKILDILGETCKSEPVKEESSELEQPFAQDTSSVGPDRKLAEEEDLFDSAHPEEGDLDLASESTAHAQSSKADSLLAVVK
396,sp|P10914|IRF1_HUMAN,208,264,56,Prediction,LYNFQVSPMPSTSEATTDEDEEGKLPEDIMKLLEQSEWQPTNVDGKGYLLNEPGVQ
397,sp|Q5EBL2|ZN628_HUMAN,895,947,52,Prediction,AAEELLTGPGPGEAGDGEASTGVVQDVLFETLQTDEGLQSVLVLSGADGEQT
398,sp|Q9UL49|TCFL5_HUMAN,19,75,56,Prediction,AAVEGAGGGDAALGEPGLSFTTTDLSLVEMTEVEYTQLQHILCSHMEAAADGELET
399,sp|Q8WYN3|CSRN3_HUMAN,127,184,57,Prediction,EKLNSLKLKMTKNGTVESEEASTLTLDDISDDDIDLDNTEVDEYFFLQPLPTKKRRA
400,sp|P35716|SOX11_HUMAN,2,46,44,Prediction,QQAESLEAESNLPREALDTEEGEFMACSPVALDESDPDWCKTAS
401,sp|P35716|SOX11_HUMAN,198,269,71,Prediction,VLGSLRVSGSGGGGAGKTVKCVFLDEDDDDDDDDDELQLQIKQEPDEEDEEPPHQQLLQPPGQQPSQLLRR
402,sp|P35716|SOX11_HUMAN,389,441,52,Prediction,LSLSLVDKDLDSFSEGSLGSHFEFPDYCTPELSEMIAGDWLEANFSDLVFTY
403,sp|Q96JM7|LMBL3_HUMAN,709,749,40,Prediction,TDEVSEFIQSLPGCEEHGKVFKDEQIDGEAFLLMTQTDIV
404,sp|Q13342|SP140_HUMAN,352,394,42,Prediction,VSCLSAETFDLKTPQVTNEGEPEKELSLLPGEGEEGSDDCSE
405,sp|Q68EA5|ZNF57_HUMAN,7,45,38,Prediction,DVAVDFTLEEWALLDSAQRDLYRDVMLETFRNLASVDD
406,sp|Q9UJW8|ZN180_HUMAN,10,54,44,Prediction,AGSGAQDLSTLLCLEESMEEQDEKPPEPPKACAQDSFLPQEIII
407,sp|P17021|ZNF17_HUMAN,1,43,42,Prediction,NLTEDYMVFEDVAIHFSQEEWGILNDVQRHLHSDVMLENFAL
408,sp|Q96NZ1|FOXN4_HUMAN,403,460,57,Prediction,PVDFINISTDMNTEVDALDPSIMDFALQGNLWEEMKDEGFSLDTLGAFADSPLGCDL
409,sp|P32314|FOXN2_HUMAN,53,92,39,Prediction,DELTNLNWLHESTNLLTNFSLGSEGLPIVSPLYDIEGDD
410,sp|O60381|HBP1_HUMAN,23,72,49,Prediction,RASGMNDSLELLQCNENLPSSPGYNSCDEHMELDDLPELQAVQSDPTQS
411,sp|O60381|HBP1_HUMAN,229,269,40,Prediction,EWQDVEDFARAEGCDNEEDLQMGIHKGYGSDGLKLLSHEE
412,sp|P36956|SRBP1_HUMAN,1,60,59,Prediction,DEPPFSEAALEQALGEPCDLDAALLTDIEDMLQLINNQDSDFPGLFDPPYAGSGAGGTD
413,sp|Q8NFU7|TET1_HUMAN,375,414,39,Prediction,WELPGADPVHGEALGETPDLPEIPGAIPVQGEVFGTILD
414,sp|Q8NFU7|TET1_HUMAN,1963,2013,50,Prediction,SEADEPPSDEPLSDDPLSPAEEKLPHIDEYWSDSEHIFLDANIGGVAIAP
415,sp|Q9H0D2|ZN541_HUMAN,46,107,61,Prediction,AGLSGLDPDPSLPTPDMSSEVLEDNLDTLSLYSGKDSDSVKLLEEYADSESQASLQDLGLG
416,sp|Q9Y2N7|HIF3A_HUMAN,443,513,70,Prediction,LSADLPDELPVGTENVHRLFTSGKDTEAVETDLDIAQDADALDLEMLAPYISMDDDFQLNASEQLPRAYH
417,sp|Q9UGL1|KDM5B_HUMAN,864,917,53,Prediction,LLNRVEDFQQHSQKLLSEETPSAAELQDLLDVSFEFDVELPQLAEMRIRLEQA
418,sp|Q6P280|ZN529_HUMAN,16,81,65,Prediction,AVMPEVEFPDQFFTVLTMDHELVTLRDVVINFSQEEWEYLDSAQRNLYWDVMMENYSNLLSLDLE
419,sp|Q6ZV50|RFX8_HUMAN,413,486,73,Prediction,MTLCHRDSFGSWHLFHLLLLEYMIHILQSCLEEEEEEEDMGTVKEMLPDDPTLGQPDQALFHSLNSSLSQACA
420,sp|Q16236|NF2L2_HUMAN,161,289,128,Prediction,AQSPETSVAQVAPVDLDGMQQDIEQVWEELLSIPELQCLNIENDKLVETTMVPSPEAKLTEVDNYHFYSSIPSMEKEVGNCSPHFLNAFEDSFSSILSTEDPNQLTVNSLNSDATVNTDFGDEFYSAF
421,sp|P11474|ERR1_HUMAN,324,363,39,Prediction,EYVLLKALALANSDSVHIEDAEAVEQLREALHEALLEYE
422,sp|Q969W8|ZN566_HUMAN,1,48,47,Prediction,AQESVMFSDVSVDFSQEEWECLNDDQRDLYRDVMLENYSNLVSMGHS
423,sp|P48378|RFX2_HUMAN,653,701,48,Prediction,EHRVAEATGETPIAVMGEFNDLASLSLTLLDKDDMGDEQRGSEAGPDA
424,sp|P52742|ZN135_HUMAN,103,142,39,Prediction,EEISNSVILVERFLWDGLWYCRGEDTEGHWEWSCESLES
425,sp|Q5VVJ2|MYSM1_HUMAN,209,255,46,Prediction,NAVKIEKLSDDEEVDITDEVDELSSQTPQKNSSSDLLLDFPNSKMH
426,sp|P53539|FOSB_HUMAN,177,218,41,Prediction,ELTDRLQAETDQLEEEKAELESEIAELQKEKERLEFVLVAH
427,sp|Q6ZMS4|ZN852_HUMAN,76,116,40,Prediction,LFGVVPGGTETGDVCEDTFKELEGQPSNEEGSRLESDFLE
428,sp|A8MQ14|ZN850_HUMAN,1,42,41,Prediction,NMEGLVMFQDLSIDFSQEEWECLDAAQKDLYRDVMMENYSS
429,sp|Q96BA8|CR3L1_HUMAN,10,97,87,Prediction,DRLFPGSSFLDLGDLNESDFLNNAHFPEHLDHFTENMEDFSNDLFSSFFDDPVLDEKSPLLDMELDSPTPGIQAEHSYSLSGDSAPQ
430,sp|Q15776|ZKSC8_HUMAN,13,137,124,Prediction,PDQTPEEDLVIVKVEEDHGWDQESSLHESNPLGQEVFRLRFRQLRYQETLGPREALIQLRALCHQWLRPDLNTKEQILELLVLEQFLTILPEELQTLVKEHQLENGEEVVTLLEDLERQIDILG
431,sp|O60678|ANM3_HUMAN,13,162,149,Prediction,AVENEEDLPELSDSGDEAAWEDEDDADLPHGKQQTPCLFCNRLFTSAEETFSHCKSEHQFNIDSMVHKHGLEFYGYIKLINFIRLKNPTVEYMNSIYNPVPWEKEEYLKPVLEDDLLLQFDVEDLYEPVSVPFSYPNGLSENTSVVEKL
432,sp|P15172|MYOD1_HUMAN,1,65,64,Prediction,ELLSPPLRDVDLTAPDGSLCSFATTDDFYDDPCFDSPDLRFFEDLDPRLMHVGALLKPEEHSHF
433,sp|Q96HQ0|ZN419_HUMAN,3,52,49,Prediction,AALRDPAQVPVAADLLTDHEEGYVTFEDVAVYFSQEEWRLLDDAQRLLY
434,sp|Q96PN7|TREF1_HUMAN,1143,1200,57,Prediction,LLPLDQLSLIKPIKDVDILDDDVVQQLGGVMEEAEVVDTDLLLDDQDSVLLQGDAEL
435,sp|Q03112|MECOM_HUMAN,179,288,109,Prediction,APGEELLLFMKSEDYPHETMAPDIHEERQYRCEDCDQLFESKAELADHQKFPCSTPHSAFSMVEEDFQQKLESENDLQEIHTIQECKECDQVFPDLQSLEKHMLSHTEE
436,sp|Q03112|MECOM_HUMAN,1039,1084,45,Prediction,PRNVEERMNGSHFKDEKALVTSQNSDLLDDEEVEDEVLLDEEDED
437,sp|Q9H165|BC11A_HUMAN,9,66,57,Prediction,QHLSKREFSPEPLEAILTDDEPDHGPLGAPEGDHDLLTCGQCQMNFPLGDILIFIEH
438,sp|O95365|ZBT7A_HUMAN,282,321,39,Prediction,LSEAAPEPGDSPGFLSGAAEGEDGDGPDVDGLAASTLLQ
439,sp|Q7Z7K2|ZN467_HUMAN,84,139,55,Prediction,TCPGEEWMIRKVKVEDEDQEAEEEVEWPQHLSLLPSPFPAPDLGHLAAAYKLEPG
440,sp|Q12950|FOXD4_HUMAN,17,72,55,Prediction,RDSDGEDGKIDVLGEEEDEDEEEAASQQFLEQSLQPGLQVARWGGVALPREHIEG
441,sp|O95625|ZBT11_HUMAN,118,172,54,Prediction,CQEKLDRSRPISDVSEMLEELGLDLESGEESNESEDDLSNFTSSPTTASKPAKK
442,sp|Q9P2Z0|THA10_HUMAN,207,251,44,Prediction,ATTQTEELWSRTSSLFDIYSSDSETDTDWDIKSEQSDLSYMAVQ
443,sp|Q9UL58|ZN215_HUMAN,96,135,39,Prediction,LAILPEEVRTWVNLQHPNNSKDMVTLIEDVIEMLEDEDM
444,sp|P17029|ZKSC1_HUMAN,97,154,57,Prediction,LLVLEQFLSILPKELQVWLQEYRPDSGEEAVTLLEDLELDLSGQQVPGQVHGPEMLA
445,sp|Q9NP62|GCM1_HUMAN,1,40,39,Prediction,EPDDFDSEDKEILSWDINDVKLPQNVKKTDWFQEWPDSY
446,sp|Q03933|HSF2_HUMAN,333,397,64,Prediction,SLTSEDPVTMMDSILNDNINLLGKVELLDYLDSIDCSLEDFQAMLSGRQFSIDPDLLVDLFTSS
447,sp|Q03933|HSF2_HUMAN,471,522,51,Prediction,EVLSSVDKPIEVDELLDSSLDPEPTQSKLVRLEPLTEAEASEATLFYLCEL
448,sp|Q8WYA1|BMAL2_HUMAN,568,636,68,Prediction,MGELEATRQNQSTVAVHSHEPLLSDGAQLDFDALCDNDDTAMAAFMNYLEAEGGLGDPGDFSDIQWTL
449,sp|Q96LX8|ZN597_HUMAN,37,86,49,Prediction,LSKDGTKESLEDAALMGEEGKPEINQQLSLESMELDELALEKYPIAAPL
450,sp|Q9P243|ZFAT_HUMAN,484,554,70,Prediction,QEALVFTSSINQSFCLLEPGGDIQQEALGDQLQLVEEEFALQGVNALKEEACPGDTQLEEGRKEPEAPGE
451,sp|P04150|GCR_HUMAN,195,254,59,Prediction,DLEFSSGSPGKETNESPWRSDLLIDENCLLSPLAGEDDSFLLEGNSNEDCKPLILPDTK
452,sp|Q9NQX1|PRDM5_HUMAN,84,133,49,Prediction,VHEAPSQEQKNLAAIQEGENIFYLAVEDIETDTELLIGYLDSDMEAEEE
453,sp|Q9HCX3|ZN304_HUMAN,26,64,38,Prediction,EWELLEEAQRFLYRDVMLENFALVATLGFWCEAEHEAP
454,sp|Q6ZSZ6|TSH1_HUMAN,511,557,46,Prediction,DAEKIKEESEDSLEKFEPSTLYPYLREEDLDDSPKGGLDILKSLEN
455,sp|Q9H7R0|ZN442_HUMAN,4,45,41,Prediction,GGEDRSDLFLPDSQTNEERKQYDSVAFEDVAVNFTQEEWAL
456,sp|Q53EQ6|TIGD5_HUMAN,500,550,50,Prediction,EEAAEHSRVLSDLTHLAALAYKCLAPEEVAEWLHLDDDGGPPEGCREEVG
457,sp|P57071|PRD15_HUMAN,1249,1290,41,Prediction,EVLAVRIDDLDHLPETTTIDASSIGIVQPELTLEQEDLAEG
458,sp|Q14209|E2F2_HUMAN,386,437,51,Prediction,DQFLSPTLACSSPLISFSPSLDQDDYLWGLEAGEGISDLFDSYDLGDLLIN
459,sp|Q04206|TF65_HUMAN,428,484,56,Prediction,TQAGEGTLSEALLQLQFDDEDLGALLGNSTDPAVFTDLASVDNSEFQQLLNQGIPV
460,sp|Q9Y2K7|KDM2A_HUMAN,628,668,40,Prediction,NEETQDFEKKLMECCICNEIVHPGCLQMDGEGLLNEELPN
461,sp|O60284|ST18_HUMAN,267,317,50,Prediction,DGNAQPSFPDVEEEDSESLAVMTEEGSDLEKAKGNLSLLEQAIALQAERG
462,sp|P35869|AHR_HUMAN,549,587,38,Prediction,FEDIRHMQNEKFFRNDFSGEVDFRDIDLTDEILTYVQD
463,sp|Q13469|NFAC2_HUMAN,27,66,39,Prediction,LDFSILFDYEYLNPNEEEPNAHKVASPPSGPAYPDDVLD
464,sp|Q8IY51|TIGD4_HUMAN,384,485,101,Prediction,GESDITNAEKDTGLDLVADALGAGVEFPEGLSIEEYAALDDDLETCEAAPNGDSICTKESKSDETGFYTSDEEDDDGSPGTELPLPSKSEAITALDTLKKF
465,sp|Q8N141|ZFP82_HUMAN,5,48,43,Prediction,VMFSDVSIDFSPEEWEYLDLEQKDLYRDVMLENYSNLVSLGCF
466,sp|Q15047|SETB1_HUMAN,9,48,39,Prediction,LDAATATVESEEIAELQQAVVEELGISMEELRHFIDEEL
467,sp|Q15047|SETB1_HUMAN,825,875,50,Prediction,GSFVCIYAGKILTDDFADKEGLEMGDEYFANLDHIESVENFKEGYESDAP
468,sp|Q9BVI0|PHF20_HUMAN,328,379,51,Prediction,SRLSTNGTHEILDPDLVVSDLVDTDPLQDTLSSTKESEEGQLKSALEAGQV
469,sp|Q9BVI0|PHF20_HUMAN,603,650,47,Prediction,KVKALEEDNLSESSSESFLWSDDEYGQDVDVTTNPDEELDGDDRYDF
470,sp|Q9BVI0|PHF20_HUMAN,937,989,52,Prediction,WQFNLLTHVESLQDEVTHRMDSIEKELDVLESWLDYTGELEPPEPLARLPQL
471,sp|P17022|ZNF18_HUMAN,153,197,44,Prediction,VEPHLEVVPQELGLENSSSGPGELLSHIVKEESDTEAELALAAS
472,sp|P17022|ZNF18_HUMAN,314,366,52,Prediction,ASGEVPSQASLRGFFTEDEPGCFGEGENLPEALQNIQDEGTGEQLSPQERIS
473,sp|Q8NA42|ZN383_HUMAN,1,41,40,Prediction,AEGSVMFSDVSIDFSQEEWDCLDPVQRDLYRDVMLENYGN
474,sp|P78412|IRX6_HUMAN,223,287,64,Prediction,AEGGEEDSLGCLTADTKEVTASQEARGLRLSDLEDLEEEEEEEEEAEDEEVVATAGDRLTEFRK
475,sp|P35713|SOX18_HUMAN,290,334,44,Prediction,GPYPGPLSPPPEAPPLESAEPLGPAADLWADVDLTEFDQYLNCS
476,sp|Q96HZ4|HES6_HUMAN,173,217,44,Prediction,PPGPGDDLCSDLEEAPEAELSQAPAEGPDLVPAALGSLTTAQIA
477,sp|P19838|NFKB1_HUMAN,261,305,44,Prediction,VTGGEEIYLLCDKVQKDDIQIRFYEEEENGGVWEGFGDFSPTDV
478,sp|P19838|NFKB1_HUMAN,729,803,74,Prediction,GSTRLAALLKAAGADPLVENFEPLYDLDDSWENAGEDEGVVPGTTPLDMATSWQVFDILNGKPYEPEFTSDDLL
479,sp|Q9H1K0|RBNS5_HUMAN,2,43,41,Prediction,SLDDPGEVREGFLCPLCLKDLQSFYQLHSHYEEEHSGEDRD
480,sp|Q9H1K0|RBNS5_HUMAN,700,769,69,Prediction,LSSPLVPGNPFEEPTCINPFEMDSDSGPEAEEPIEEELLLQQIDNIKAYIFDAKQCGRLDEVEVLTENL
481,sp|Q9UDV6|ZN212_HUMAN,141,276,135,Prediction,SLENDGVCFTEQEWENLEDWQKELYRNVMESNYETLVSLKVLGQTEGEAELGTEMLGDLEEEGPGGAHPAGGVMIKQELQYTQEGPADLPGEFSCIAEEQAFLSPEQTELWGGQGSSVLLETGPGDSTLEEPVGS
482,sp|Q5VUA4|ZN318_HUMAN,1966,2026,60,Prediction,ETWESPEKPKTEALELQDVHPELTVTIESKALEDFEATDLKVEELTALGNLGDMPVDFCT
483,sp|Q9NP71|MLXPL_HUMAN,263,306,43,Prediction,PSPLQLPPEDAYVGNADMIQPDLTPLQPSLDDFMDISDFFTNS
484,sp|Q7RTS3|PTF1A_HUMAN,1,76,75,Prediction,DAVLLEHFPGGLDAFPSSYFDEDDFFTDQSSRDPLEDGDELLADEQAEVEFLSHQLHEYCYRDGACLLLQPAPPA
485,sp|Q96SF7|TBX15_HUMAN,32,73,41,Prediction,RDWEEKGLDLSMEALSPAGPLGDTEDAAAHGLEPHPDSEQS
486,sp|Q6NT04|TIGD7_HUMAN,399,449,50,Prediction,ENLLYKKEPEYDFQGLEHGDYREILEKCGELETKLDDDRVWLNGDEEKGC
487,sp|Q6VB84|FX4L3_HUMAN,26,75,49,Prediction,IDVLGEEEDEDEVEDEEEAASQQFLEQSLQPGLQVARWGGVALPREHIE
488,sp|Q9BRR0|ZKSC3_HUMAN,1,49,48,Prediction,ARELSESTALDAQSTEDQMELLVIKVEEEEAGFPSSPDLGSEGSRERF
489,sp|Q9BRR0|ZKSC3_HUMAN,106,147,41,Prediction,REQHPESGEEVVVLLEYLERQLDEPAPQVSGVDQGQELLCC
490,sp|Q9BT81|SOX7_HUMAN,305,346,41,Prediction,PPEHPGFDALDQLSQVELLGDMDRNEFDQYLNTPGHPDSAT
491,sp|Q9C0A1|ZFHX2_HUMAN,78,135,57,Prediction,GPDCGHFPPNDPGVEKDKEQEEEEEGLPPMDLSNHLFFTAGGEAYLVAKLSLPGGSE
492,sp|Q8TAU0|NKX23_HUMAN,25,78,53,Prediction,HFHGAHLQADLEHHFHSAPCMLAAAEGTQFSDGGEEDEEDEGEKLSYLNSLAA
493,sp|Q8NEK5|ZN548_HUMAN,19,58,39,Prediction,EEWGHLDEAQRLLYRDVMLENLALLSSLGSWHGAEDEEA
494,sp|Q6R2W3|SCND3_HUMAN,83,220,137,Prediction,EIHTKEQILELLVLEQFLTILPEELQSWVREHNPESGEEVVTLLEDLERELDEPRQQVSQGTYGQEVSMEEMIPLDSAKESLGTQLQSMEDRMECESPEPHPLQDNGSFLWFSMMSQSMGGDNLSSLDTNEAEIEPE
495,sp|Q6R2W3|SCND3_HUMAN,519,574,55,Prediction,ESAFSSEAKLGLSHSQLTEELVASLHTENELDQADKELENTLRAQYEENIETGTD
496,sp|Q92610|ZN592_HUMAN,3,46,43,Prediction,MKTPDFDDLLAAFDIPDPTSLDAKEAIQTPSEENESPLKPPGI
497,sp|Q99459|CDC5L_HUMAN,476,518,42,Prediction,RLGLLGLPAPKNDFEIVLPENAEKELEEREIDDTYIEDAADV
498,sp|Q8NBB4|ZSCA1_HUMAN,104,150,46,Prediction,SCREAASLVEDLTQMCQQEVLVSLDSVEPQDWSFGEEEDGKSPRSQ
499,sp|Q9UMN6|KMT2B_HUMAN,1954,2016,62,Prediction,SGELAPPGPAPSPPPPEDLGPDFEDMEVVSGLSAADLDFAASLLGTEPFQEEIVAAGAMGSS
500,sp|Q9UMN6|KMT2B_HUMAN,2340,2397,57,Prediction,GEPAGEESPGPLQERSPLLPLPEDGPPQVPDGPPDLLLESQWHHYSGEASSSEEEPP
501,sp|A8MYZ6|FOXO6_HUMAN,229,279,50,Prediction,WAASPASHASDDYEAWADFRGGGRPLLGEAAELEDDEALEALAPSSPLMY
502,sp|A8MYZ6|FOXO6_HUMAN,421,487,66,Prediction,AAGPLGAAPDRFPADLDLDMFSGSLECDVESIILNDFMDSDEMDFNFDSALPPPPPGLAGAPPPNQ
503,sp|Q15075|EEA1_HUMAN,112,150,38,Prediction,LEKYQGLQQQEAKPDGLVTDSSAELQSLEQQLEEAQTE
504,sp|Q96BT3|CENPT_HUMAN,292,334,42,Prediction,AQFLAGEAEEVNAFALGFLSTSSGVSGEDEVEPLHDGVEEAE
505,sp|O14709|ZN197_HUMAN,228,267,39,Prediction,EEWACLGPIQRALYWDVMLENYGNVTSLEWETMTENEEV
506,sp|Q9ULL5|PRR12_HUMAN,931,972,41,Prediction,ICFPDSLLQDEERSFFPTMEEMFGGGAADDYGKAGPPEDEG
507,sp|Q9ULL5|PRR12_HUMAN,1986,2025,39,Prediction,DQTLAIEGGAEDLGQEEVVQQCMRNQPWLEQLFDSFSDL
508,sp|Q15911|ZFHX3_HUMAN,486,525,39,Prediction,EDEGCKGLFPSELDEELEDRPHEEPGAAAGSSSKKDLAL
509,sp|Q15911|ZFHX3_HUMAN,1446,1505,59,Prediction,HLETSHLELSEADIQQLYGGLLANGDLLAMGDPTLAEDHTIIVEEDKEEESDLEDKQSP
510,sp|P10070|GLI2_HUMAN,404,445,41,Prediction,CALPLSQEQLADLKEDLDRDDCKQEAEVVIYETNCHWEDCT
511,sp|Q9Y5W3|KLF2_HUMAN,25,71,46,Prediction,RWPRAEPESGGTDDDLNSVLDFILSMGLDGLGAEAAPEPPPPPPPP
512,sp|Q6EKJ0|GTD2B_HUMAN,544,582,38,Prediction,VAYSIAIDEITDINNTTQLAIFIRGVDENFDVSEELLD
513,sp|Q9BW11|MAD3_HUMAN,140,205,65,Prediction,AGAAERERLRADSLDSSGLSSERSDSDQEELEVDVESLVFGGEAELLRGFVAGQEHSYSHGGGAW
514,sp|Q9H3D4|P63_HUMAN,44,91,47,Prediction,QTNEFLSPEVFQHIWDFLEQPICSVQPIDLNFVDEPSEDGATNKIEI
515,sp|Q9BS31|ZN649_HUMAN,54,93,39,Prediction,DALTKLEQGEPLWTLEDEIHSPAHPEIEKADDHLQQPLQ
516,sp|Q86UP3|ZFHX4_HUMAN,468,514,46,Prediction,PGDEDEEDAYSNELDDEEVLGELTDSIGNKDFPLLNQSISPLSSSV
517,sp|Q86UP3|ZFHX4_HUMAN,1056,1106,50,Prediction,HQQGLAPEEDNLSEIFFVKDCPPNELETASLGARTCDDDLTEQHEEAEGA
518,sp|Q86UP3|ZFHX4_HUMAN,1396,1449,53,Prediction,KHLEAGHPELSEAELQQLYASLPVNGELWAESETMSQDDHGLEQEMEREYEVD
519,sp|Q86UP3|ZFHX4_HUMAN,2809,2857,48,Prediction,PTTEVCDDKFLFSLTSPSIHFNDKDGDHDQSFYITDDPDDNADRSETS
520,sp|Q86UP3|ZFHX4_HUMAN,3505,3545,40,Prediction,TSSLCSTSGVQTSLPTESCSDESDSELSQKLEDLDNSLEV
521,sp|P28324|ELK4_HUMAN,270,310,40,Prediction,PLSSHPDIDTDIDSVASQPMELPENLSLEPKDQDSVLLEK
522,sp|Q68CJ9|CR3L3_HUMAN,53,100,47,Prediction,VLPNPDSDDFLSSILGSGDSLPSSPLWSPEGSDSGISEDLPSDPQDT
523,sp|Q68CJ9|CR3L3_HUMAN,386,425,39,Prediction,EADTTREESPGSPGADWGFQDTANLTNSTEELDNATLVL
524,sp|Q12772|SRBP2_HUMAN,1,59,58,Prediction,DDSGELGGLETMETLTELGDELTLGDIDEMLQFVSNQVGEFPDLFSEQLCSSFPGSGG
525,sp|P23497|SP100_HUMAN,122,181,59,Prediction,EALFSDVNMQEYPDLIHIYKGFENVIHDKLPLQESEEEEREERSGLQLSLEQGTGENSF
526,sp|O15156|ZBT7B_HUMAN,280,338,58,Prediction,ELVYPPAYGLAQGGGPPLSPEELGSDEDAIDPDLMAYLSSLHQDNLAPGLDSQDKLVR
527,sp|Q15329|E2F5_HUMAN,295,343,48,Prediction,GSISGDIIDELMSSDVFPLLRLSPTPADDYNFNLDDNEGVCDLFDVQI
528,sp|Q96NJ3|ZN285_HUMAN,82,122,40,Prediction,DLTVSQDYIVNLQEECSPHLEDVSLSEEWAGISLQISENE
529,sp|Q9Y2K1|ZBTB1_HUMAN,473,514,41,Prediction,QDLTMNGLGNTEEKMDLEENPDEQSEIRDMFVEMLDDFRDN
530,sp|Q86YE8|ZN573_HUMAN,86,124,38,Prediction,PWMILREETQFTDLDLQCEIISYIEVPTYETDISSTQL
531,sp|Q9P0U4|CXXC1_HUMAN,261,321,60,Prediction,ASSTVKEPPEATATPEPLSDEDLPLDPDLYQDFCAGAFDDHGLPWMSDTEESPFLDPALR
532,sp|Q13127|REST_HUMAN,76,129,53,Prediction,MPVGDNNFSDSEEGEGLEESADIKGEPHGLENMELRSLELSVVEPQPVFEASG
533,sp|Q15744|CEBPE_HUMAN,16,67,51,Prediction,PLEFSGGRAGPGELGDMCEHEASIDLSAYIESGEEQLLSDLFAVKPAPEAR
534,sp|Q8WXT5|FX4L4_HUMAN,26,75,49,Prediction,IDVLGEEEDEDEVEDEEEEARQQFLEQSLQPGLQVARWGGVALPREHIE
535,sp|Q9UIF9|BAZ2A_HUMAN,255,412,157,Prediction,VPSVESLHQEVSVLVPDPTVSCLDDPSHLPDQLEDTPILSEDSLEPFNSLAPEPVSGGLYGIDDTELMGAEDKLPLEDSPVISALDCPSLNNATAFSLLADDSQTSTSIFASPTSPPVLGESVLQDNSFDLNNGSDAEQEEMETQSSDFPPSLTQPA
536,sp|Q9UFB7|ZBT47_HUMAN,182,226,44,Prediction,GPAQPFFKEEKEGGVEEAGGPPASLCKLEGGEELEEELGGSGTY
537,sp|Q8TCN5|ZN507_HUMAN,340,386,46,Prediction,SAERGVHLSQSVTLDPNEEEMLEVISDAEENLIPDSLLTSAQKIIS
538,sp|Q15554|TERF2_HUMAN,146,195,49,Prediction,QCLSRIEEGENLDCSFDMEAELTPLESAINVLEMIKTEFTLTEAVVESS
539,sp|Q9BUY5|ZN426_HUMAN,21,75,54,Prediction,EKTPAGRIVADCLTDCYQDSVTFDDVAVDFTQEEWTLLDSTQRSLYSDVMLENY
540,sp|Q66K89|E4F1_HUMAN,598,640,42,Prediction,GCLLEVEELLVSEDSPAAATTVLTEDPHTVLVEFSSVVADTQ
541,sp|Q8TAQ5|ZN420_HUMAN,9,93,84,Prediction,DVAIDFSQEEWECLDSAQRDLYRDVMLENYSNLVSLDLPSRCASKDLSPEKNTYETELSQWEMSDRLENCDLEESNSRDYLEAK
542,sp|O43309|ZSC12_HUMAN,77,159,82,Prediction,ETHTKEQILELLVLEQFLTILPEELQAWVQEQHPESGEEVVTVLEDLERELDEPGEQVSVHTGEQEMFLQETVRLRKEGEPS
543,sp|Q5MCW4|ZN569_HUMAN,55,93,38,Prediction,VIFKLEQEEEPWVMEEEVLRRHWQGEIWGVDEHQKNQD
544,sp|Q9NS56|TOPRS_HUMAN,465,505,40,Prediction,DLNNDSDDSSDNCVIVGFVKPLAERTPELVELSSDSEDLG
545,sp|Q9NS56|TOPRS_HUMAN,920,971,51,Prediction,KEDTECDNSGPQDPLQNEFLAPSLEPFETKDVVTIEAEFGVLDKECDIATL
